AABEL=ABALE
AABCE=ABACE
AABET=ABATE
AABIŢ=ABAŢI
ABCES=ABCES,BASCE
AĂBIL=ABILĂ,BĂLAI
ABIIL=ABILI,ALBII,ALIBI,BALII
ABEIL=ABILE,ALBEI,ALBIE,BALIE
ABILO=ABOLI
AABNO=ABONA
AABRŞ=ABRAŞ
ABIRU=ABURI,ARBIU,BARIU,BRUIA,RUBAI,RUBIA
AABUZ=ABUZA
AACJU=ACAJU
AACNT=ACANT,CANAT
AACIR=ACARI,ACIRA,ARACI,CARIA
AAĂCS=ACASĂ
AACIŢ=ACAŢI
AAĂCŢ=ACĂŢA
ACCES=ACCES
ACEEL=ACELE,ACELE,CELEA
AACEL=ACELA,CEALA
AACEE=ACEEA
AACEI=ACEIA,AICEA
AACER=ACERA
AĂCER=ACERĂ,CEARĂ
ACEER=ACERE
ABCER=ACERB,BECAR
ACEST=ACEST,ASCET,CASTE,CESTA,TEASC,TESAC
ACHIU=ACHIU
ACHII=ACHII
AĂCDI=ACIDĂ,ADICĂ,DAICĂ
ACIIZ=ACIZI,CAIZI,ZAICI
ACDEI=ACIDE
ACIIL=ACILI,ALICI,ILIAC,LAICI
AACIL=ACILA
ACEIN=ACINE,ANCIE
AACIU=ACIUA
ACIIU=ACIUI
ACEEN=ACNEE
ACLOO=ACOLO
ACNOT=ACONT,CANTO,CONTA,OCTAN
ACDOR=ACORD,DOCAR
ACIRŞ=ACRIŞ,ARŞIC,CRAŞI
ACIRT=ACRIT,TRACI
ACIRU=ACRIU,ARCUI
ACEIR=ACRIE,CAIER,CARIE,CEAIR
ACIIR=ACRII,ARICI,CARII
ACRŢU=ACRUŢ,CRUŢA,CUARŢ
ACITV=ACTIV
ACORT=ACTOR,COTAR,CROAT,ORTAC,TAROC
AACMU=ACUMA
AACŞU=ACUŞA
ACIŞU=ACUŞI
AĂCTU=ACUTĂ,CĂUTA
ACIŢU=ACUŢI
ACETU=ACUTE
AACUZ=ACUZA,CAUZA
AĂCUZ=ACUZĂ,CAUZĂ
ACEUZ=ACUZE,CAUZE
AADOS=ADAOS
AADSU=ADAUS,ASUDA
AAĂDP=ADĂPA
AĂCDE=ADECĂ,CĂDEA
ADEPT=ADEPT
AADER=ADERA
ADEES=ADESE
ACDHO=ADHOC
AÂCDN=ADÂNC
AADNT=ADNAT
AADOR=ADORA
ACDEU=ADUCE,EDUCA
ACDTU=ADUCT,DUCAT
AADLU=ADULA
ADLTU=ADULT
AADNU=ADUNA
AĂDSU=ADUSĂ
ADIŞU=ADUŞI
ADESU=ADUSE
ADNOV=ADVON
AAEJR=AERAJ
AAERT=AERAT,ARATE,ATARE
ABEOR=AEROB,BOARE,OARBE,ROABE
AEORS=AEROS,ROASE
AAĂFR=AFARĂ
ACEFT=AFECT
AAFGN=AFGAN
ADEFI=AFIDE,DAFIE,FIDEA
AĂFIN=AFINĂ,FAINĂ
AFIIN=AFINI,FAINI
AEFIN=AFINE,FAINE
AAFIN=AFINA
AFINO=AFION,AFONI
AFIPT=AFIPT
AEFIŞ=AFIŞE
AAFIŞ=AFIŞA
AEFIX=AFIXE
AAÂFN=AFÂNA
AFLUX=AFLUX
AĂFNO=AFONĂ
AEFNO=AFONE
AFORT=AFTOR,FROTA
AAFMU=AFUMA
ADFNU=AFUND,FUNDA
AAEGL=AGALE,ALEGA,EGALA
AAĂGP=AGAPĂ
AAEGP=AGAPE
AAAGS=AGASA
AAEGT=AGATE
AAĂGT=AGATĂ
AAĂGV=AGAVĂ
AAEGV=AGAVE
AAĂGŢ=AGĂŢA
AEGNT=AGENT
AĂEGR=AGERĂ,RĂGEA
AEGIR=AGERI
AEEGR=AGERE
AEGST=AGEST
AĂGIL=AGILĂ
AGIIL=AGILI
AEGIL=AGILE,ALGIE,EGALI,GAELI
AAGIT=AGITA,TAIGA
AAGNT=AGNAT
AEGNŢ=AGNEŢ
AĂGNO=AGONĂ,GOANĂ
AAGOR=AGORA,AROGA
AAGRR=AGRAR
AĂGIR=AGRĂI
AAEGR=AGREA,ARGEA,RAGEA
AGIRŞ=AGRIŞ,GRAŞI
AGIUZ=AGUZI
AĂDGU=AGUDĂ
ADEGU=AGUDE
AAHIT=AHTIA
AEIST=AIEST,AISTE,IESTA,IASTE
AEEIV=AIEVE
AIIOR=AIORI
AIIŞT=AIŞTI,IŞTIA
AAIST=AISTA,IASTA,IASTA
AIORŞ=AIŞOR
AAIRU=AIURA
AEIRU=AIURE,AUREI,AURIE
AIIRU=AIURI,AURII
AAJNU=AJUNA
AJNSU=AJUNS
AAJRU=AJURA
AAJTU=AJUTA
AÂIKN=AKÂNI
AAILT=ALAIT,ALIAT
AAĂLM=ALAMĂ
AAILN=ALANI,ALINA,ANALI
AALNU=ALAUN,ANUAL,ANULA
AĂILM=ALĂMI,ALĂMI,MĂLAI,MIALĂ
ABELŢ=ALBEŢ
ABILT=ALBIT
ABILU=ALBIU,ALBUI,LABIU
ABLMU=ALBUM,UMBLA
ABLŞU=ALBUŞ
ABLŢU=ALBUŢ
AACLN=ALCAN,CANAL
ACLOV=ALCOV,VOCAL
AADLN=ALDAN
ADILN=ALDIN,LADIN
AAELN=ALEAN,ANALE,ANALE
AEEGL=ALEGE,EGALE,GEALE
AĂELN=ALENĂ
AEELN=ALENE
AELRT=ALERT,TALER
AEILŞ=ALEŞI
AEELS=ALESE
AAELZ=ALEZA
ADGIL=ALGID
AAIJL=ALIAJ
AAILS=ALIAS
AĂCIL=ALICĂ,LAICĂ
ACEIL=ALICE,CLAIE,LAICE
AIILN=ALINI,LINIA
AILNT=ALINT,LATIN,LIANT
AILOR=ALIOR,OLARI,ORALI
AIILP=ALIPI
AALMR=ALMAR,MALAR
AEELM=ALMEE
AACLO=ALOCA
AILNP=ALPIN,LIPAN
AALRT=ALTAR,TALAR,TARLA
AILOT=ALTOI,ATOLI
ALLTU=ALTUL
AIILŢ=ALŢII
AALTU=ALUAT
AILNU=ALUNI,ULANI
AĂLNU=ALUNĂ
AELNU=ALUNE
AĂLRU=ALURĂ
AAMNT=AMANT,MANTA,TAMAN
AAĂMR=AMARĂ,ARAMĂ
AAIMR=AMARI,ARIMA,RAMIA
AAEMR=AMARE
AAAMR=AMARA
AĂGIM=AMĂGI
AĂÎMR=AMĂRÎ
AABMR=AMBAR
ABIIM=AMBII,IAMBI
AĂBMR=AMBRĂ,BRAMĂ
ABEMR=AMBRE,BAREM,BRAME
AEMNT=AMENT,MANTE,METAN
AEIMŢ=AMEŢI
AAIMZ=AMIAZ
AĂBIM=AMIBĂ
ABEIM=AMIBE
AĂCIM=AMICĂ,MAICĂ
ACIIM=AMICI,MAICI
ACEIM=AMICE
AĂDIM=AMIDĂ
ADEIM=AMIDE,MEDIA
AEIMZ=AMIEZ,AZIME,MIAZE
AIILM=AMILI
AĂIMN=AMINĂ
AEIMN=AMINE,MANIE
AIMNO=AMINO,MOINA
AAÂMN=AMÂNA
AAMNR=AMNAR,ARMAN
AFMOR=AMORF,FORMA
AEMPR=AMPER,RAMPE
ALMPU=AMPLU
AĂLMP=AMPLĂ,LAMPĂ
AILMP=AMPLI
AELMP=AMPLE
AGMRU=AMURG
AIMŞU=AMUŞI
AIMŢU=AMUŢI
AAMUZ=AMUZA
AMNOV=AMVON
AAĂLN=ANALĂ
ACIIN=ANCII
ADINN=ANDIN
AĂENX=ANEXĂ
AEENX=ANEXE
AAENX=ANEXA
AGILN=ANGLI
AGNOR=ANGRO,ARGON,ORGAN
AAIMN=ANIMA,MANIA
AAINN=ANINA
AINNO=ANION,NOIAN
AINOZ=ANOZI
ANOST=ANOST,TASON
AANOŞ=ANŞOA
AALNT=ANTAL,NATAL,TALAN
AENTT=ANTET,ATENT,TENTA
ACINT=ANTIC,TANIC
AMNTU=ANTUM
AANRU=ANUAR
AEMNU=ANUME,UMANE
ANNŢU=ANUNŢ
AĂNRU=ANURĂ
AENRU=ANURE
AELOO=AOLEO
AELOU=AOLEU
AĂORT=AORTĂ,ROATĂ
AEORT=AORTE,ROATE
AAIPR=APARI,ARAPI
AAEPR=APARE
AAIPŞ=APAŞI
AAĂPR=APĂRA
AAĂPS=APĂSA
AAELP=APELA
AĂDIP=APIDĂ
ADEIP=APIDE
AILOP=APIOL
AILPT=APLIT
AEENP=APNEE
AĂDOP=APODĂ
AIOPZ=APOZI
ADEOP=APODE
AOPRT=APORT,TROPA
AIOPŞ=APOŞI
AEPRT=APRET,APTER,TRAPE
AGIPR=APRIG,GRIPA
AILPR=APRIL
ADOPR=APROD
AACPU=APUCA
AENPU=APUNE
AAPPU=APUPA
AĂPSU=APUSĂ
AIPŞU=APUŞI
AEPSU=APUSE
AAĂBR=ARABĂ
AABIR=ARABI
AABER=ARABE
AAĂRT=ARATĂ,ARĂTA
AAIRŢ=ARAŢI
AĂCIR=ARĂCI
AĂIMR=ARĂMI
ABEIR=ARBIE,BAIER,BARIE,RABIE
ABORR=ARBOR
AACNR=ARCAN,CANAR
AACRŞ=ARCAŞ
AACRT=ARCAT,CARAT,CARTA,CATAR,TARAC
ACRŞU=ARCUŞ
ADEIR=ARDEI,ARIDE,DARIE
AAELR=AREAL
AĂENR=ARENĂ
AEENR=ARENE
AERST=AREST,TRASE
AAGRT=ARGAT
AGORU=ARGOU,GAROU
AGRSU=ARGUS
AHNOR=ARHON
AAINR=ARIAN
AĂDIR=ARIDĂ
AIIRZ=ARIZI,IRIZA,RAZII
AIINR=ARINI
AĂIPR=ARIPĂ
AIIPR=ARIPI
AAMRR=ARMAR
AAMRŞ=ARMAŞ
AAMRT=ARMAT,TAMAR
AÂMNR=ARMÂN
AEIMR=ARMIE,MIARE
AIIMR=ARMII
AAMOR=AROMA
AĂMOR=AROMĂ,MOARĂ
AEMOR=AROME,MOARE
AIMOR=AROMI,MAIOR,MAORI,MORIA
AENRS=ARSEN
AINRŞ=ARŞIN
AORST=ARTOS
AAGRŢ=ARŢAG
AARRŢ=ARŢAR
AALST=ASALT,ATLAS
AAANS=ASANA
AAĂRS=ASARĂ
AACES=ASECA
AIINS=ASINI
AĂISZ=ASIZĂ
AEISZ=ASIZE
ACIPS=ASPIC
AIPRS=ASPRI
APRSU=ASPRU
AĂPRS=ASPRĂ
AEPRS=ASPRE
AĂMST=ASTMĂ
ARSTU=ASTRU
AIRŞT=AŞTRI,TRAŞI,TRIŞA
AAMSU=ASUMA
AAIŞŞ=AŞAŞI
AAEŞZ=AŞEZA
AAACT=ATACA
AAEŞT=ATAŞE
AAAŞT=ATAŞA
AĂELT=ATELĂ
AEELT=ATELE,ELEAT
AĂCIT=ATICĂ,TAICĂ
ACIIT=ATICI
ACEIT=ATICE,CAIET,IETAC
AAÂTT=ATÂTA
AÂITŢ=ATÂŢI
AALTZ=ATLAZ,TALAZ
AELTT=ATLET
AIMOT=ATOMI
AĂNOT=ATONĂ,TOANĂ
AINOT=ATONI
AENOT=ATONE,TOANE
AIRTU=ATRIU,AURIT,IAURT,TAURI
AAELT=ATALE,ETALA
AĂCIŢ=AŢICĂ,ŢAICĂ
AEINŢ=AŢINE,NAŢIE,ŢINEA
AIIPŢ=AŢIPI
AAÂŢŢ=AŢÂŢA
AIOŞŢ=AŢOŞI
AADIU=AUDIA
ADIOU=AUDIO
AGRUU=AUGUR
AELUU=AULEU
ACILU=AULIC
AARRU=AURAR
AELRU=AUREL,LUARE,RELUA
AIRUU=AURIU
AELŞU=AUŞEL
AEIŞU=AUŞEI
AORTU=AUTOR
AAETV=AVAET
AAĂNV=AVANĂ
AAINV=AVANI
AAENV=AVANE
AANSV=AVANS
AAĂRV=AVARĂ
AAIRV=AVARI,VARIA
AAERV=AVARE
AAIŢV=AVAŢI
AĂENV=AVENĂ
AEENV=AVENE
AEERV=AVERE
AEIRV=AVERI,VAIER,VARIE
AERSV=AVERS
AIIVZ=AVIZI
AĂDIV=AVIDĂ
ADEIV=AVIDE,DEVIA
AINOV=AVION,INOVA
AAIVV=AVIVA
AEIVZ=AVIZE
AAIVZ=AVIZA
AIOVZ=AVIZO
AÂNTV=AVÂNT,VÂNAT
AORTV=AVORT
AAMRV=AVRAM
AĂTUV=AVUTĂ
AETUV=AVUTE
AIŢUV=AVUŢI
AAERX=AXARE
AĂIRX=AXĂRI
AAILX=AXIAL
AĂILX=AXILĂ
AEILX=AXILE,EXILA
AINOX=AXION,AXONI
AĂIMZ=AZIMĂ,IAZMĂ,MIAZĂ
ACETZ=AZTEC
AĂIŞT=ĂŞTIA
AAEST=ASTEA
AABBC=BABAC
AABBN=BABAN,NABAB
AABBU=BABAU
ABBIO=BABOI
AABCL=BACAL,CABLA
AĂBCU=BACĂU
ABCIL=BACIL
ABCNO=BACON,BANCO,BONCA
AĂBFT=BAFTĂ
AABGJ=BAGAJ
AABEG=BAGEA,GEABA
ABCHI=BAHIC
AĂBHN=BAHNĂ
ABEHN=BAHNE
AABLŞ=BALAŞ
ABELT=BALET,TABEL,TABLE
ABLNO=BALON
ABLOT=BALOT,LOBAT
AABLS=BALSA
AĂBLT=BALTĂ,TABLĂ
ĂBILŢ=BĂLŢI
AABLN=BANAL,LABAN
AABNN=BANAN
AABNT=BANAT,TABAN
AĂBCN=BANCĂ,BĂCAN
ĂBCIN=BĂNCI
AĂBDN=BANDĂ
ABDEN=BANDE
BEINZ=BENZI
ABJNO=BANJO
AĂBNT=BANTĂ,BĂNAT
BEINŢ=BENŢI
ABNTU=BANTU,BUTAN,TABUN
AABJR=BARAJ
AABRT=BARAT,RABAT,TABAR
AĂBBR=BARBĂ
ĂBBIR=BĂRBI
AĂBCR=BARCĂ
ĂBCIR=BĂRCI
ABIRZ=BARZI,BARIZ,BIZAR,BRAZI
AĂBDR=BARDĂ,DĂRAB,RĂBDA
ĂBIRZ=BĂRZI,BRIZĂ,RĂZBI
ABEJR=BAREJ,JABRE
ABCIR=BARIC,BRACI,CRABI,RABIC
ABIIR=BARII,RABII
ABILR=BARIL
ABIMR=BARIM
ABIRŞ=BARIŞ
ABCOR=BAROC
ABNOR=BARON
ABORS=BAROS
ABORU=BAROU,BOUAR
AĂBRZ=BARZĂ
BEERZ=BERZE,BREZE,ZEBRE
AĂBCS=BASCĂ
ABCIS=BASCI
ĂBIŞT=BĂŞTI,BĂŞTI
ABEST=BASET,TABES
ABEMS=BASME
AABMS=BASMA
AĂBNS=BASNĂ
ABENS=BASNE
AABST=BASTA
AABCŞ=BAŞCA
AĂBCŞ=BAŞCĂ
AĂBŞT=BAŞTĂ
AABLT=BATAL,TABLA
AABTT=BATAT
AABTV=BATAV
AĂBRT=BATĂR,BĂRAT
AĂBCT=BATCĂ
ABCET=BATCE
ABCIT=BATIC
ABIRT=BATIR
ABITU=BATIU
AÂBRT=BATÂR
ABCOT=BATOC
ABGOT=BATOG,BOGAT
ABNOT=BATON
AABRZ=BAZAR
ABCIZ=BAZIC
ABINZ=BAZIN
ABNOZ=BAZON
ĂBBIO=BĂBOI
ĂBCIT=BĂCIT
ĂBCDI=BĂDIC
ĂBDEI=BĂDIE
ĂBDII=BĂDII
AĂBIŞ=BĂIAŞ
AĂBIT=BĂIAT,BIATĂ
ĂBEIŞ=BĂIEŞ
ĂBEIT=BĂIET
ĂĂBIŢ=BĂIŢĂ
ĂBEIŢ=BĂIŢE
AĂBLN=BĂLAN,BLANĂ,NALBĂ
ĂBLOS=BĂLOS,LĂBOS
ĂBILT=BĂLTI
ĂBLŢU=BĂLUŢ
ĂBENT=BĂNET
ĂBEIN=BĂNIE
ĂBIIN=BĂNII
ĂBNOS=BĂNOS
ĂBINU=BĂNUI,BĂUNI
ĂBNŢU=BĂNUŢ
AĂBMS=BĂSMA
ĂBINS=BĂSNI
ĂĂBIT=BĂTĂI
ĂBTTU=BĂTUT
ĂBOSŢ=BĂŢOS
ĂĂBTU=BĂUTĂ
ĂBETU=BĂUTE
ĂBIŢU=BĂUŢI
AĂBET=BEATĂ
BCEER=BECER,BERCE,REBEC
ĂBEHI=BEHĂI
ABEEL=BELEA
BEGIL=BELGI,BLEGI
BEILT=BELIT,BILET
BELMO=BEMOL
ABEGN=BENGA
BEINŞ=BENIŞ
ABERR=BERAR
BCEIR=BERCI,BRICE,CERBI
BEERT=BERET
BEILR=BERIL,LIBER
ĂBENR=BERNĂ
BEISS=BESSI
BENOT=BETON
BEEIŢ=BEŢIE
BEIIŢ=BEŢII,BIEŢI
BEIŢV=BEŢIV
ABEEZ=BEZEA
ĂBENZ=BEZNĂ
BEENZ=BEZNE
ABBIN=BIBAN
BBEIR=BIBER,BREBI
BBCII=BIBIC
BDEIU=BIDEU
BDINO=BIDON
ĂBEIL=BIELĂ
BEEIL=BIELE
BEEIT=BIETE
ABGIM=BIGAM
BGIOT=BIGOT
BIIJO=BIJOI
ABIMN=BIMAN
ABINR=BINAR,RABIN
BIINŞ=BINIŞ
BIMNO=BINOM
BDEIP=BIPED
ĂBIRU=BIRĂU,RĂBUI
ĂBIIR=BIRĂI
ĂBIJR=BIRJĂ
BEIJR=BIRJE,BREJI
BIORU=BIROU,BOURI
BIIRU=BIRUI
BEIRT=BITER
BIMTU=BITUM
BILOV=BIVOL
ABIMZ=BIZAM
BEIŢZ=BIZEŢ
BINOZ=BIZON,BONZI
BIIUZ=BIZUI
ÂBHIL=BÂHLI
ÂBCIL=BÂLCI
ĂÂBFR=BÂRFĂ
ÂBEFR=BÂRFE
ÂBFIR=BÂRFI
ÂÂBIR=BÂRÂI
ĂÂBNR=BÂRNĂ,BRÂNĂ
ÂBENR=BÂRNE
ĂÂBRS=BÂRSĂ
ÂBERS=BÂRSE
ÂÂBIŢ=BÂŢÂI
ÂÂBIZ=BÂZÂI
ÂBIOZ=BÂZOI
AABLM=BLAMA
ĂBILN=BLĂNI,NĂLBI
ABCLN=BLANC
AABLZ=BLAZA
AĂBLZ=BLAZĂ
ABEHL=BLEAH,HALBE,HLEAB
ABELU=BLEAU
ABELV=BLEAV
BEEGL=BLEGE
BELOT=BLEOT,TOLBE
BDEIL=BLIDE,DEBIL,DIBLE
BILTZ=BLITZ
ÂBDLN=BLÂND
ABCLO=BLOCA,BOCAL
BDLNO=BLOND
BELSU=BLUES
BGILU=BLUGI
ĂBLUZ=BLUZĂ
BELUZ=BLUZE
AĂBBO=BOABĂ
ABBEO=BOABE,BOABE
AĂBCO=BOACĂ
AĂBLO=BOALĂ,OABLĂ
ABIOR=BOARI
AĂBOŢ=BOAŢĂ
ABEOŢ=BOAŢE
BBEOR=BOBER
BBCOO=BOBOC
BBOOT=BOBOT
BCEOT=BOCET,BOTCE
BCIOT=BOCIT
ĂBCNO=BOCNĂ
ĂBCOŞ=BOCŞĂ
BCEOŞ=BOCŞE
ĂBEMO=BOEMĂ
BEIMO=BOEMI
BEEMO=BOEME
BEIOR=BOIER,BOIRE,OBERI,ORBIE,ROBIE,ROIBE
BIIOR=BOIRI,ROBII,ROIBI
BCJOO=BOJOC
BGJOO=BOJOG
BDILO=BOLDI,BOLID
ĂBFLO=BOLFĂ
BEFLO=BOLFE
ĂBLOT=BOLTĂ,TOLBĂ
BILOŢ=BOLŢI
BILOT=BOLTI
ABBMO=BOMBA
ĂBBMO=BOMBĂ
BBEMO=BOMBE
BMNOO=BONOM
BINOŢ=BONŢI
BINOT=BONTI
ABORT=BORAT
ABORX=BORAX
BDOOR=BORDO
BCIOR=BORIC,CORBI
ÂBORT=BORÂT
ĂBNOR=BORNĂ
BENOR=BORNE
BIORŞ=BORŞI,ORBIŞ
ĂBORT=BORTĂ,TORBĂ
BEORT=BORTE,TORBE
BIORT=BORTI,ORBIT,ROBIT
ĂBORZ=BORZĂ
BEORZ=BORZE
ABEOŞ=BOAŞE,EBOŞA
ABORŞ=BOŞAR,BROŞA
ĂBCOT=BOTCĂ
BEIOT=BOTEI
BEOTZ=BOTEZ
BOOST=BOTOS
BIOTŢ=BOŢIT
BIOŢU=BOUŢI
BINOV=BOVIN
BEORX=BOXER
BEIOZ=BOZIE,OBEZI,OBEZI
BIIOZ=BOZII
ABDRT=BRADT
AĂBGR=BRAGĂ,GRABĂ
ĂBGIR=BRĂGI,GRĂBI
AĂBHR=BRAHĂ
ABDNR=BRAND
ABNRŢ=BRANŢ
ABERŢ=BRAŢE
AĂBRV=BRAVĂ
ABIRV=BRAVI,VIBRA
ABERV=BRAVE
AABRV=BRAVA
ABORV=BRAVO
ABERZ=BREAZ,BREZA
ĂBERŞ=BREŞĂ
BEERŞ=BREŞE
ĂBERV=BREVĂ
BEERV=BREVE,VERBE
BCIIR=BRICI,IBRIC
ĂBDIR=BRIDĂ
BDEIR=BRIDE,DERBI
BEIRZ=BRIZE
ÂBEIR=BRÂIE
ABDOR=BRODA
BDIOR=BRODI,DROBI
BNORZ=BRONZ
ĂBORŞ=BROŞĂ
BEORŞ=BROŞE
BFRTU=BRUFT
ABMRU=BRUMA
ĂBMRU=BRUMĂ,RUMBĂ,UMBRĂ
BEMRU=BRUME,RUMBE,UMBRE
ĂBNRU=BRUNĂ
BINRU=BRUNI,RUBIN
BENRU=BRUNE
ABNRU=BRUNA,URBAN
BCRSU=BRUSC
ĂBRTU=BRUTĂ,BURTĂ,TURBĂ
BIRŢU=BRUŢI,BURŢI
BERTU=BRUTE,BURET,REBUT,TURBE
BORTU=BRUTO
ABBTU=BUBAT
BBIOU=BUBOI
BBNOU=BUBON
BBOSU=BUBOS
BBIUU=BUBUI
ABCLU=BUCAL,BUCLA,CABLU
ABCEU=BUCEA
BCEHU=BUCHE
BCHIU=BUCHI
BCINU=BUCIN,BUNIC,INCUB
ĂBCLU=BUCLĂ,BULCĂ
BCELU=BUCLE
ĂBCŞU=BUCŞĂ
BCEŞU=BUCŞE
BCIŞU=BUCŞI
ĂBDIU=BUDĂI
BEFTU=BUFET
BEFUU=BUFEU
ĂBFNU=BUFNĂ
BEFNU=BUFNE
BFINU=BUFNI
BFNOU=BUFON
BDEGU=BUGED
BEGTU=BUGET
ĂBGLU=BUGLĂ
BEGLU=BUGLE
ABHIU=BUHAI
ABHUV=BUHAV
ĂBHIU=BUHĂI
ĂBHNU=BUHNĂ
BEHNU=BUHNE
BHOSU=BUHOS
BHRUU=BUHUR
ABCIU=BUIAC,CUIBA
BCIIU=BUICI
ĂBDJU=BUJDĂ
BDEJU=BUJDE
BDIJU=BUJDI
BEIJU=BUJIE
BIIJU=BUJII
BJORU=BUJOR
BBILU=BULBI
BCILU=BULCI
BELTU=BULET
BILNU=BULIN,NUBIL
BLNOU=BULON
BCLUU=BULUC
BILUZ=BULZI
BBIMU=BUMBI
ĂBDNU=BUNDĂ
BDENU=BUNDE
BELNU=BUNEL
BEINU=BUNEI
BNŢUU=BUNUŢ
ABJRU=BURAJ
ABRTU=BURAT,BUTAR,TURBA
ĂBBRU=BURBĂ
BBERU=BURBE
ĂBCRU=BURCĂ,CURBĂ
BCIRU=BURCI,BURIC,CURBI
BIRUU=BURIU
BEIRU=BURIE,ERBIU
ĂBRSU=BURSĂ
BERSU=BURSE,REBUS
ABSTU=BUSTA
BELŞU=BUŞEL
BEIŞU=BUŞEI
BEŞUU=BUŞEU
BNOŞU=BUŞON
ABCTU=BUTAC
ABŞTU=BUTAŞ
ĂBCTU=BUTCĂ
BCITU=BUTCI
BEITU=BUTIE
BIITU=BUTII,IUBIT
BIOTU=BUTOI
BNOTU=BUTON
BCTUU=BUTUC
BRTUU=BUTUR
ABTUZ=BUZAT
ĂBRUZ=BUZĂR,ZURBĂ
ĂBUUZ=BUZĂU
ABNUZ=BUZNA
BINUZ=BUZNI
BIOUZ=BUZOI
AABCZ=CABAZ
AABCR=CABRA
AACCO=CACAO
ACCMO=CACOM
ACDET=CADET
ACDIU=CADIU
ACDII=CADII,DAICI
ACDOU=CADOU
AACDR=CADRA,CARDA,DARAC
AĂCDR=CADRĂ,CARDĂ,DĂRAC
ACDRU=CADRU
ACDER=CADRE,CARDE,DECAR
ACCDU=CADUC
AACFS=CAFAS
AACEF=CAFEA
ACFIR=CAFRI,CIFRA
ACFIT=CAFTI,FICAT
AĂCHL=CAHLĂ,HALCĂ
ACEHL=CAHLE
AACCI=CAIAC
ACCEI=CAICE
ACIIŞ=CAIŞI
AĂCIS=CAISĂ,IASCĂ
ACEIS=CAISE
AACJL=CALAJ
ACCEL=CALCE,CECAL
AĂCDL=CALDĂ,CLADĂ
ACILZ=CALZI
ACDEL=CALDE,CLADE
ACELM=CALEM,CALME,CLAME,MACLE
AĂCFL=CALFĂ,FACLĂ,FALCĂ
ACEFL=CALFE,FACLE,FALCE,FLEAC
ACCIL=CALIC
ACFIL=CALIF,FACIL
ACILN=CALIN,LINCA
AĂCLM=CALMĂ,CLAMĂ,MACLĂ,MLACĂ
ACILM=CALMI
AACLM=CALMA,CLAMA,MALAC
ACLOS=CALOS
AĂCLP=CALPĂ,CLAPĂ
ACILP=CALPI
ACELP=CALPE,CLAPE
ACLPU=CALUP,CUPLA
ACLSU=CALUS
ACEEM=CAMEE
AACFN=CANAF
ACCIN=CANCI
AACEN=CANEA
ACEGN=CANGE
ĂCGIN=CĂNGI
ACDIN=CANID
ACINN=CANIN
ACINŞ=CANIŞ,INCAŞ
ACENO=CANOE,COANE,OCEAN
ACNNO=CANON
AACCP=CAPAC
AACNP=CAPAN
AĂCPT=CAPĂT
ACEPR=CAPER,CAPRE
ACEPŞ=CAPEŞ
ACEIP=CAPIE,CAPIE
ACIPU=CAPIU
ACIIP=CAPII
ACCOP=CAPOC,COPAC
ACNOP=CAPON,COPAN
ACOPT=CAPOT
AĂCPR=CAPRĂ,CRĂPA
AACPS=CAPSA
AĂCPS=CAPSĂ
ACEPS=CAPSE
AACPT=CAPTA
AACRS=CARAS
ACERT=CARET,CARTE,CERAT,CERTA,TRACE
ACERU=CAREU,CUREA
ACCIR=CARIC,CICAR,CIRAC,CIRCA,CRACI
ACENR=CARNE,CRANE,ECRAN
ACORU=CAROU
ACIPR=CARPI,CRAPI
ACRST=CARST
AĂCRT=CARTĂ,CĂRAT,TĂRCA,TRACĂ
ĂCIRŢ=CĂRŢI,CRIŢĂ,ŢĂRCI
ABCRU=CARUB,CURBA
AACST=CASAT
AĂCCS=CASCĂ,CĂSCA
ĂCIŞT=CĂŞTI
ACISU=CASIU
ACIIS=CASII
AĂCST=CASTĂ
ACIŞT=CAŞTI
AÂCRT=CATÂR
ACDOT=CATOD,CODAT
ACCEU=CAUCE
AACFV=CAVAF
AACLV=CAVAL
AACSV=CAVAS
ACOUV=CAVOU
AACCZ=CAZAC
AACNZ=CAZAN
ACCIZ=CAZIC
AACMZ=CAZMA,MACAZ
AĂCNZ=CAZNĂ,NĂCAZ
ACENZ=CAZNE,CNEAZ,NECAZ
ACNOZ=CAZON
AĂCIN=CĂINA,NAICĂ
ĂĂCIŢ=CĂIŢĂ,CĂŢĂI
ĂCEIŢ=CĂIŢE,CĂŢEI,CĂŢIE
ĂĂCLU=CĂLĂU,CĂULĂ
ĂĂCIL=CĂLĂI
AĂCCL=CĂLCA,CLACĂ
ĂCILN=CĂLIN,CLINĂ,LĂNCI
ĂCILT=CĂLIT,CLĂIT,CLĂTI
ĂCLŞU=CĂLUŞ
ĂCLŢU=CĂLUŢ
ĂCIMN=CĂMIN
ĂĂCPU=CĂPĂU
ĂĂCIP=CĂPĂI
AĂCIP=CĂPIA
ĂCIPU=CĂPUI
ĂCPŞU=CĂPUŞ
ĂCRŢU=CĂRUŢ,ŢURCĂ
ĂCIOS=CĂSOI
ĂĂCIŞ=CĂŞĂI
ĂCŞŢU=CĂŞUŢ,ŢUŞCĂ
ĂĂCRT=CĂTRĂ
ĂCERT=CĂTRE,CERTĂ,CRETĂ
ĂCNTU=CĂTUN
ĂCRTU=CĂTUR,CUTRĂ,TURCĂ
AĂCEŢ=CĂŢEA,CEAŢĂ
ĂCELŢ=CĂŢEL
ĂCIIŢ=CĂŢII
ĂCIŢU=CĂŢUI,ŢUICĂ
ĂCELU=CĂULE,LEUCĂ
ĂCEŞU=CĂUŞE
ĂCINZ=CĂZNI
ĂCTUZ=CĂZUT,ZĂCUT
AĂCEF=CEAFĂ
AĂCEP=CEAPĂ
CEEPS=CEPSE
CEEPŢ=CEPŢE
CEIŞT=CEŞTI,CEŞTI
AĂCET=CEATĂ,TĂCEA,TEACĂ
ACENU=CEAUN
ACEŞU=CEAUŞ
CCEMU=CECUM
CDERU=CEDRU,CRUDE
CDEIR=CEDRI,CRIDE
ACEFR=CEFAR,FRECA
ĂCEHI=CEHĂI
ACELR=CELAR,CLARE,LACRE,RACLE
ACELL=CELLA
CELLO=CELLO
CELMO=CELOM
ĂCELT=CELTĂ,LETCĂ
CEILŢ=CELŢI,ŢICLE
CEELT=CELTE
ACELT=CELTA
CEILU=CELUI,CIULE,LECUI,LEUCI,LICEU,LUCIE
CEINŢ=CENŢI
CEINT=CENTI,ETNIC,ICNET,TICNE
ĂCEIP=CEPĂI,EPICĂ
ACCER=CERCA
CCEIR=CERCI
ĂCEGR=CERGĂ
CEGIR=CERGI,GRECI
CEIRU=CERIU,CERUI,CUIER,CURIE,URICE
CEENR=CERNE
CEINR=CERNI,RENCI
CEORS=CEROS,CROSE
CEIRŞ=CERŞI,RICŞE
CEIRŢ=CERŢI,CREŢI
CEERT=CERTE,CRETE,ERECT,RECTE,TRECE
CERTU=CERUT,CURTE,CUTER,CUTRE,TURCE
CEISU=CESIU
CEEST=CESTE
ACEŞT=CETAŞ
CEETŢ=CETEŢ
CEOSŢ=CEŢOS
ĂCCEU=CEUCĂ
CCEEU=CEUCE
ACERZ=CEZAR,CRAZE
ACEGH=CHEAG
CEEHI=CHEIE
CEEHL=CHELE
CEHIL=CHELI,CHILE
ACEHM=CHEMA
ACEHR=CHERA
ĂCEHT=CHETĂ
CEEHT=CHETE
ACHIR=CHIAR
BCHIZ=CHIBZ
ĂCCHI=CHICĂ
CCHII=CHICI
ĂCHIL=CHILĂ,HĂLCI
CHIOR=CHIOR,ROCHI
CHIOT=CHIOT,OCHIT
CHIST=CHIST
CHIIŢ=CHIŢI
ĂCHIT=CHITĂ
CEHIT=CHITE
CHIIT=CHITI
CHIIU=CHIUI
CHILU=CHIUL
CHIPU=CHIUP
CCILU=CICLU,CULIC
CDIRU=CIDRU
CEIIR=CIERI
ĂCFIR=CIFRĂ,FRICĂ
CEFIR=CIFRE,FERIC,RECIF
CFIRU=CIFRU,FURCI
ĂCHII=CIHĂI,HICĂI
CCIIN=CINCI,CINIC
CEILN=CINEL,CLENI,CLINE
CIIOR=CIORI
BCIIO=CIOBI
CINOT=CIONT,ONTIC,OTINC,TONIC
CCIIP=CIPIC
CIIPR=CIRIP
CIIRŞ=CIRIŞ
ĂCIRT=CIRTĂ,RĂCIT
CIRSU=CIRUS
ĂCILS=CISLĂ,CLISĂ
CEILS=CISLE,CLISE
ACITT=CITAT,TACIT
CEITŢ=CITEŢ
CIITT=CITIT
ĂCDIU=CIUDĂ
CDIIU=CIUDI
CIINU=CIUIN,CUINI,UNCII,UNICI
ĂCILU=CIULĂ,LĂCUI
CIILU=CIULI,LUCII
ĂCIMU=CIUMĂ,MUICĂ
CEIMU=CIUME
CIMPU=CIUMP
CGINU=CIUNG
CINTU=CIUNT
CIIPU=CIUPI
ĂCITU=CIUTĂ
CIIŢU=CIUŢI,ŢICUI,ŢUICI
CEITU=CIUTE,CUTIE,TEUCI
CCIIV=CIVIC
CIILV=CIVIL
CIITV=CIVIT
ĂCIMZ=CIZMĂ,ZĂMCI
CEIMZ=CIZME
ÂCEIN=CÂINE
ÂCIIN=CÂINI
ÂCILŢ=CÂLŢI
ÂCENR=CÂNER,CÂRNE
AÂCNT=CÂNTA
ĂÂCCR=CÂRCĂ
ÂÂCIR=CÂRÂI,RÂCÂI
ĂÂCJR=CÂRJĂ
ÂCEJR=CÂRJE
ĂÂCMR=CÂRMĂ
ÂCEMR=CÂRME
ÂCIMR=CÂRMI
ĂÂCNR=CÂRNĂ,RÂNCĂ
ÂCINR=CÂRNI,CÂRNI,RÂNCI
ĂÂCPR=CÂRPĂ
ÂCEPR=CÂRPE
ÂCIPR=CÂRPI
ÂCIRT=CÂRTI
ÂCIŞT=CÂŞTI
AÂCET=CÂTEA
AÂCTV=CÂTVA
AACCL=CLACA
ĂCCIL=CLĂCI,CLICĂ
ACLMP=CLAMP
ACCLN=CLANC
ACLNŢ=CLANŢ
ACCLP=CLAPC
AĂCLR=CLARĂ,LACRĂ,LĂCAR,RACLĂ
ACILR=CLARI
AACLS=CLASA
AĂCLS=CLASĂ
ACELS=CLASE
ĂCDIL=CLĂDI
ACELN=CLEAN,LANCE
ĂCELM=CLEMĂ,MĂCEL
CEELM=CLEME
CCIIL=CLICI
ĂCILM=CLIMĂ,MLĂCI
CEILM=CLIME,MELCI
CIILN=CLINI
CCILN=CLINC
CGILN=CLING
CILNT=CLINT
ĂCILP=CLIPĂ,LIPCĂ
CEILP=CLIPE
CIILP=CLIPI
CILPS=CLIPS
ACILŞ=CLIŞA,LACŞI
ACILV=CLIVA
CCILO=CLOCI,COCLI,COLIC
CCLNO=CLONC
CLNOŢ=CLONŢ
CLNOV=CLOVN
ĂCLPU=CLUPĂ,CULPĂ,CUPLĂ
CELPU=CLUPE,CULPE,CUPLE
CEIJN=CNEJI
ACCEO=COACE
AĂCDO=COADĂ
AACFO=COAFA
AĂCJO=COAJĂ,JOACĂ
AĂCLO=COALĂ
AĂCMO=COAMĂ,MOACĂ
ACEMO=COAME,MOACE
AĂCNO=COANĂ
CIORZ=CORZI
AĂCOS=COASĂ
ACEOS=COASE
ABCIO=COBAI
ĂBCIO=COBĂI
ĂBCOR=COBRĂ
BCEOR=COBRE
BCORU=COBUR
BCOUZ=COBUZ
ĂBCOZ=COBZĂ
BCEOZ=COBZE
CCEIO=COCIE
CCIIO=COCII
CCNOO=COCON
CCOOR=COCOR
CCOOS=COCOS
CCOOŞ=COCOŞ
ACDJO=CODAJ
ACDNO=CODAN
ACDOŞ=CODAŞ
CDEOX=CODEX
CDOOŞ=CODOŞ
CDORU=CODRU
CDIOR=CODRI,DORIC
CEFIO=COFEI
ACEIO=COAIE
CIJOT=COJIT
CCJOO=COJOC
ACCLO=COLAC
ACJLO=COLAJ
ACLNO=COLAN
ACELO=COLEA,OCALE,OLACE
CEGLO=COLEG
CELOT=COLET
CEILO=COLIE,OCELI,OLEIC
CIILO=COLII
CILOU=COLIU,LOCUI
CILNO=COLIN
CILOR=COLIR,CORLI
ĂCLNO=COLNĂ
CELNO=COLNE
CLNOO=COLON
CLOOS=COLOS
CILOŢ=COLŢI
CLNOU=COLUN
ACMOT=COMAT,TOCMA
CEMOT=COMET,METOC
CCIMO=COMIC
CIMOS=COMIS
CDMOO=COMOD
CMOOR=COMOR,CROMO
CMNOU=COMUN
ACCNO=CONAC
ĂCCNO=CONCĂ
CCINO=CONCI,CONIC
CENOŢ=CONEŢ
CENOX=CONEX
CENOT=CONTE
CINOŢ=CONŢI
ACIOP=COPAI,COPIA,OPACI
ĂCIOP=COPĂI,OPĂCI
ACLOP=COPAL
ĂCCOP=COPCĂ
CCIOP=COPCI
CEIOP=COPIE,EPOCI
CIIOP=COPII,COPII
CILOP=COPIL
CIOOP=COPOI
ĂCOPR=COPRĂ
CEOPR=COPRE
CIOPŢ=COPŢI
ĂCOPT=COPTĂ
CEOPT=COPTE
ACIOR=CORAI
ACJOR=CORAJ
ACLOR=CORAL,CORAL
ACNOR=CORAN,ORCAN
CCIOR=CORCI,ORCIC
CEEOR=COREE
CEORŢ=COREŢ
CEORU=COREU
CEIOR=COREI,EROIC,ORICE
ĂCFOR=CORFĂ
CEFOR=CORFE
ĂCLOR=CORLĂ
CELOR=CORLE,CREOL
CINOR=CORNI,ORNIC
CIOOR=COROI
CIOPR=CORPI
ACCOS=COSAC
ACORS=COSAR
ACOSŞ=COSAŞ
CIOST=COSIT,OSTIC
CIOOS=COSOI
COORS=COSOR
ACOST=COSTA
ACORŞ=COŞAR
ACEOT=COATE,OTACE,TOACE
CEIOT=COTEI,OTICE
CEOTŢ=COTEŢ
CILOT=COTIL,LOTCI
CIOŞT=COTIŞ
CIOTT=COTIT,TOCIT
CCOOT=COTOC
CIOOT=COTOI
CNOOT=COTON
COORT=COTOR
ĂCCOŢ=COŢCĂ
CIOŢV=COVIŢ
COORV=COVOR
CORUV=COVRU
ACLOX=COXAL
AACCR=CRACA
AĂCCR=CRACĂ
ĂCCIR=CRĂCI,CRĂCI
AĂCMR=CRAMĂ,MACRĂ,MARCĂ,MĂCAR,RAMCĂ
ACEMR=CRAME,RACEM,RAMCE
ACNRŢ=CRANŢ
AĂCRS=CRASĂ
ACERS=CRASE,RESAC
ACLRU=CRAUL,LUCRA
ACNRU=CRAUN,NACRU
AĂCRZ=CRAZĂ
ĂCEIR=CRĂIE
ĂCIIR=CRĂII
CDEER=CREDE
CDEOR=CREDO,DECOR
CEEKR=CREEK
ĂCEMR=CREMĂ
CEEMR=CREME
CEPRS=CREPS
ĂCERŞ=CREŞĂ,REŞCĂ
CEERŞ=CREŞE,REŞCE
CEERŢ=CREŢE
ĂCDIR=CRIDĂ
CEIRR=CRIER
ĂCILR=CRILĂ,LICĂR
CEILR=CRILE
ĂCIMR=CRIMĂ,MĂRCI
CEIMR=CRIME
CIINR=CRINI,RICIN
ĂCIRZ=CRIZĂ
CEIRZ=CRIZE
ÂCGNR=CRÂNG
CIORT=CROIT,ORTIC,TRICO
ACMOR=CROMA,MACRO
CCNOR=CRONC
ĂCORS=CROSĂ
CCERU=CRUCE
CCIRU=CRUCI,CRUCI,CURCI
ĂCDRU=CRUDĂ
CIRUZ=CRUZI
CNRTU=CRUNT
ĂCPRU=CRUPĂ
CEPRU=CRUPE
CIRŞU=CRUŞI
ABCJU=CUBAJ
BBCEU=CUBEB
BCCIU=CUBIC
CCNOU=CUCON
CCORU=CUCOR
CCOŞU=CUCOŞ
CCIUU=CUCUI
CCŢUU=CUCUŢ
ĂCFRU=CUFĂR,FURCĂ
CEGTU=CUGET
CEHNU=CUHNE
ĂCINU=CUINĂ,NĂUCI,UNICĂ
CEINU=CUINE,UNCIE,UNICE
CIŢUU=CUIUŢ
ĂBCJU=CUJBĂ
BCEJU=CUJBE
ACCLU=CULAC,CULCA
CEELU=CULEE
CELSU=CULES
ĂCLMU=CULMĂ
CILMU=CULMI
CELMU=CULME
CLOTU=CULOT,OCULT
CELTU=CULTE
ĂCLTU=CULTĂ
CILŢU=CULŢI
ACMŞU=CUMAŞ,MUŞCA
CEMNU=CUMEN,NECUM
CIMSU=CUMIS
ÂCMSU=CUMÂS
CLMUU=CUMUL
ACMUV=CUMVA
ACJPU=CUPAJ
ACPRU=CUPAR,CUPRA
ACEPU=CUPEA
CEPŢU=CUPEŢ
CEPUU=CUPEU
CDIPU=CUPID
CIPTU=CUPIT
CIPUU=CUPIU
CLPUU=CUPLU
CNOPU=CUPON
CPRUU=CUPRU
ACJRU=CURAJ
ACRTU=CURAT,CURTA,TRUCA,TURCA,URCAT
BCERU=CURBE
ĂCCRU=CURCĂ
CEGRU=CURGE
CIIRU=CURII,ICURI
CIRUU=CURIU
ACMRU=CURMA,MUCAR
ĂCRSU=CURSĂ,RĂSUC,RUSCĂ
CERSU=CURSE,RUSCE
CIRŢU=CURŢI,ŢURCI
CLRUU=CURUL,LUCRU
CRSUU=CUSUR
CSTUU=CUSUT
ACCŞU=CUŞAC
ĂCCŞU=CUŞCĂ
CIŞTU=CUŞTI
CERŞU=CUŞER
ĂCMŞU=CUŞMĂ
CEMŞU=CUŞME
ACTTU=CUTAT
CIITU=CUTII
CITŢU=CUŢIT
ACRŢV=CVARŢ
ACISV=CVASI
ACCDI=DACIC
ACDIT=DACIT,DICTA
ADFII=DAFII
ADFIN=DAFIN
AADIR=DAIRA,RADIA
AACDL=DALAC
AĂBDL=DALBĂ
ABDIL=DALBI
ABDEL=DALBE
ADEIL=DALIE,ELIDA,IDEAL
ADIIL=DALII
AĂDLT=DALTĂ
ĂDILŢ=DĂLŢI
AADMN=DAMNA
ADDIN=DANDI
ADENZ=DANEZ,ZENDA
AADGN=DANGA
ADEIN=DANIE
ADIIN=DANII
AADNS=DANSA
AADNŢ=DANŢA
AĂDDR=DARDĂ
ADDER=DARDE
ADIIR=DARII
AADTT=DATAT
ADITV=DATIV
ADORT=DATOR,RODAT,TAROD
AĂDNU=DAUNĂ,DĂUNA
ADENU=DAUNE
ĂDILO=DĂOLI,LĂDOI
ĂĂBDR=DĂRĂB
AĂDMR=DĂRMA,DRAMĂ
ĂDIRU=DĂRUI,DURĂI,RĂDIU,UDĂRI
AĂDLU=DĂULA,LAUDĂ,LĂUDA
ĂDILU=DĂULI,DULĂI
BDEIT=DEBIT
BDETU=DEBUT
ACDEN=DECAN
CDEES=DECES
CDEIS=DECIS
ÂCDET=DECÂT
ADDEL=DEDAL
ADDET=DEDAT
DDEIO=DEDOI,DIODE
DDESU=DEDUS
DEEFL=DEFEL
DEEGT=DEGET
DEIMS=DEISM
DEIST=DEIST
DEJNU=DEJUN
CDELO=DELCO,DELOC
DEILR=DELIR,LIDER
DEILU=DELIU,DULIE,UDELI
DEEIL=DELIE
DEIIL=DELII,EDILI,IDILE
ADELT=DELTA
ĂDELT=DELTĂ
DEELT=DELTE
DELŢU=DELUŢ
DEIMU=DEMIU,MEDIU
DEIMN=DEMNI
DEEMN=DEMNE,EMDEN
ĂDEMN=DEMNĂ
DEMNO=DEMON
DEMOS=DEMOS
ADENR=DENAR,DRENA,RANDE,REDAN
DEEIN=DENIE,NEDEI
DEIIN=DENII
ĂDENS=DENSĂ
DEENS=DENSE,DESEN
DEINŞ=DENŞI
DEOPU=DEPOU
DEERŞ=DEREŞ
ĂDEMR=DERMĂ
DEEMR=DERME
AĂDES=DEASĂ
ADEGS=DESAG
DEEST=DESET
DEISŞ=DESIŞ
ĂCDEŞ=DEŞCĂ
DEEŞU=DEŞEU
DEEŞT=DEŞTE
DEERV=DEVER,DREVE,VEDRE,VERDE
DEIVZ=DEVIZ
ĂDELV=DEVLĂ
DEELV=DEVLE
DENOV=DEVON,NEVOD
CDEII=DIECI
AĂDIT=DIATĂ
ADEIT=DIATE,EDITA
ĂBDIL=DIBLĂ
BDILU=DIBLU,DUBLI
BDIIU=DIBUI,DUBII
ĂDEIT=DIETĂ
DEEIT=DIETE
DEIIZ=DIEZI
DFIUZ=DIFUZ
ADHII=DIHAI
DHIOR=DIHOR,HIDRO
ĂDIJM=DIJMĂ
DEIJM=DIJME
ADILU=DILUA
DEIMR=DIMER
DEIIM=DIMIE,MEDII,MIDIE
DIMNO=DIMON,DOMNI,DOMNI
ADIMN=DINAM
ADINR=DINAR,NADIR
DEINU=DINEU
DGINO=DINGO,GODIN
DEINT=DINTE,TINDE
DIINŢ=DINŢI
ADINŢ=DINŢA
ĂDDIO=DIODĂ
CDIIO=DIOIC,DOICI,IODIC
DILOP=DIPOL
DEIRS=DIRES,DIRES
ADIIT=DITAI
DINRU=DIURN
ADINV=DIVAN
DIINV=DIVIN
ĂÂDLM=DÂLMĂ
ÂDELM=DÂLME
AÂDNS=DÂNSA
ĂÂDRZ=DÂRZĂ
ÂDIJR=DÂRJI
ÂDERZ=DÂRZE
ÂDIRZ=DÂRZI
ÂDEJR=DÂRJE
AĂDGO=DOAGĂ
ADEGO=DOAGE
AĂDOR=DOARĂ,OARDĂ,ROADĂ
ABDOŞ=DOBAŞ
BDOOŞ=DOBOŞ
CDILO=DOCIL
ĂCDOT=DOCTĂ
CDIOŢ=DOCŢI
CDEOT=DOCTE
DDIIO=DODII
ADGOR=DOGAR,DROGA
DGIOT=DOGIT
ĂDGMO=DOGMĂ
DEGMO=DOGME
DHOOT=DOHOT
ĂCDIO=DOICĂ
DEIMO=DOIME
DIIMO=DOIMI,IDIOM
ĂDINO=DOINĂ,ODINĂ
DEINO=DOINE,ODINE
DIINO=DOINI,ODINI
ADLOR=DOLAR
DEILO=DOLIE
DIILO=DOLII,IDOLI
DILOU=DOLIU
DLMOO=DOMOL,MOLDO
ĂDMOR=DOMRĂ
DEMOR=DOMRE,MODRE
ADJOP=DOPAJ
DIMOR=DORMI
DORŢU=DORUŢ
ADORS=DOSAR
DIOST=DOSIT
DIOPS=DOSPI
ADLOT=DOTAL
ADOTT=DOTAT
ADJOZ=DOZAJ
ACDIR=DRACI
AĂDGR=DRAGĂ,GARDĂ
ADGIR=DRAGI
ADEGR=DRAGE,GRADE
AADGR=DRAGA,GRADA
ADIRV=DRAIV
ADEMR=DRAME
AADPR=DRAPA
DEEGR=DREGE
ĂDELR=DRELĂ
DEELR=DRELE
ĂDENR=DRENĂ
DEPRT=DREPT
DEIRŞ=DREŞI
DEERS=DRESE
ADERS=DRESA
DEERŢ=DREŢE
ÂDGNR=DRÂNG
DGIRU=DRUGI
ĂDGRU=DRUGĂ
ĂDPRU=DRUPĂ
DEPRU=DRUPE,DUPRE
ĂDRUZ=DRUZĂ
DERUZ=DRUZE
ABDSU=DUBAS
BDITU=DUBIT
BDIUU=DUBIU
ABDLU=DUBLA
ĂBDLU=DUBLĂ,DUBLĂ
BDELU=DUBLE,DUBLE
BDLUU=DUBLU
ACDLU=DUCAL
ĂDDUU=DUDĂU
DDIUU=DUDUI
ADELU=DUELA,ELUDA,LAUDE
DEETU=DUETE
DHINU=DUHNI
DIOSU=DUIOS
DIMUU=DUIUM
ADLPU=DULAP
ĂDLUU=DULĂU
CDELU=DULCE
CDILU=DULCI,LUCID
DIILU=DULII
ĂDGNU=DUNGĂ
DGINU=DUNGI
ĂDIPU=DUPĂI
ĂCDPU=DUPCĂ
CDEPU=DUPCE
ADRTU=DURAT
ĂDDRU=DURDĂ
DIRUZ=DURZI
DDERU=DURDE
ADERU=DUREA,UDARE
DIRTU=DURIT,TRUDI
DIMRU=DURMI,MUDIR,MURID
DIRUU=DURUI
DRTUU=DURUT
ĂCDŞU=DUŞCĂ
ĂCDTU=DUTCĂ
CDETU=DUTCE
DIORV=DVORI
ĂBEOŞ=EBOŞĂ
BEEOŞ=EBOŞE
CEEHR=ECHER
DEEEM=EDEME
CDEIT=EDICT
BEEFI=EFEBI
CEEFT=EFECT
EEFIŢ=EFEŢI
EFLUX=EFLUX
EFIOR=EFORI,FOIRE,OFERI
EFORT=EFORT,FORTE
AĂEGL=EGALĂ,GEALĂ
ĂDEGI=EGIDĂ
DEEGI=EGIDE
AEILN=ELANI,LIANE
ĂEELN=ELENĂ
EEILN=ELENI,ELINE,ILENE,INELE
EEELN=ELENE
ĂEELV=ELEVĂ
EEILV=ELEVI,VIELE
EEELV=ELEVE
CEEIL=ELICE,LICEE
ĂEILN=ELINĂ
EIILN=ELINI,LINIE
ĂEILT=ELITĂ,LEITĂ
EEILT=ELITE,LEITE
AEILM=EMAIL
AAEMN=EMANA,MANEA
EEIMR=EMERI,MEREI,MIERE
EIIMR=EMIRI
EEIMT=EMITE,TEMEI
EILMU=EMULI,UMILE
EMNOR=ENORM,NORME
EINOŢ=ENOŢI,NOIŢE
ENNŢU=ENUNŢ
CEENO=EOCEN
EILOT=EOLIT,LIOTE
AAEPT=EPATA
AĂEPV=EPAVĂ
AEEPV=EPAVE
CEIIP=EPICI
CEEIP=EPICE
AEILP=EPILA
ĂCEOP=EPOCĂ
ĂDEOP=EPODĂ
DEEOP=EPODE
ĂEHOP=EPOHĂ
EHIOP=EPOHI
EJNOP=EPONJ
AEPRU=EPURA
ĂEPRU=EPURĂ
EEPRU=EPURE,ERUPE
EQSUU=EQUUS
AĂERT=ERATĂ,TEARĂ
AEERT=ERATE
DEEER=EREDE
EEIRZ=EREZI,IEZER
EEERT=ERETE
EEIRŢ=EREŢI
AEGNR=ERGAN,GRENA
AEIJR=ERIJA
EIMRT=ERMIT,MERIT,METRI,MITRE
EIORR=ERORI,ORIER,ROIRE
ADEOR=ERODA,OARDE,ROADE,ROADE
AERŢZ=ERZAŢ,ZEŢAR
EERST=ESTER,ESTRE,TRESE
EESTT=ESTET,TESTE
CEIST=ESTIC
EISTV=ESTIV,VESTI
ENOST=ESTON,NOTES,ONEST
ERSTU=ESTRU,TRUSE
AEEJT=ETAJE
AAEJT=ETAJA
AENŞT=ETANŞ,NAŞTE
AĂEPT=ETAPĂ,TEAPĂ
AEEPT=ETAPE
AEETT=ETATE,TETEA
ĂEITŢ=ETĂŢI
ĂEENT=ETENĂ
EEENT=ETENE
EEIRT=ETERI,TEIER
EENRT=ETERN,RENTE,TEREN,TERNE,TRENE
EHOST=ETHOS
AEIJT=ETIAJ
ĂCEIT=ETICĂ,TEICĂ
CEIIT=ETICI,TEICI
CEEIT=ETICE
EIILT=ETILI,LITIE
AEILT=ETILA,LAITE,TALIE
AEIRT=ETIRA,IERTA,RAITE,REIAT,TAIER,TIARE,TREIA
ĂELOT=ETOLĂ
EELOT=ETOLE
AEFTU=ETUFA
ĂETUV=ETUVĂ
EETUV=ETUVE
CENUU=EUNUC
EIPRU=EURIP,IRUPE,RUPIE
EIRUV=EVURI,VUIRE
AADEV=EVADA,VADEA
ADETV=EVADT
AAEVZ=EVAZA
AEITV=EVITA,VAIET
ACEOV=EVOCA
EERUV=EVREU
EEIRV=EVREI
ACETX=EXACT
AAELX=EXALA
AEHRX=EXARH
CEESX=EXCES
EEGIX=EXIGE
AEIPX=EXPIA
EEPRX=EXPRE
AETXZ=EXTAZ
AERTX=EXTRA
AEITZ=EZITA
AFGOT=FAGOT
AFGRU=FAGUR,FUGAR
AĂFIM=FAIMĂ
AEFIM=FAIME,MAFIE
ĂCFIL=FĂLCI,FĂLCI
AEFLT=FALET
AEFIL=FALIE
AFIIL=FALII
AFILT=FALIT,FILAT
AĂFLS=FALSĂ
AFILŞ=FALŞI,FALŞI
AEFLS=FALSE
AĂFLŞ=FALŞĂ
AEFLŞ=FALŞE
AFLNU=FALUN
AAFMT=FAMAT
AEFMN=FAMEN
AAFLN=FANAL,FLANA
AAFNR=FANAR
AAFNT=FANAT
AADFN=FANDA
AFNNO=FANON
AĂFNT=FANTĂ
AEFNT=FANTE,FENTA
AFINŢ=FANŢI
AEFPT=FAPTE,FAPTE
AĂFPT=FAPTĂ
AADFR=FARAD,FARDA
AFINR=FARIN,INFRA
AĂFRS=FARSĂ
AEFRS=FARSE
AFNOS=FASON
AĂFST=FASTĂ
AFIŞT=FAŞTI
AEFST=FASTE
AAFLT=FATAL,FLATA
AFMTU=FATUM,FUMAT,MATUF
AFLTU=FAULT,FLAUT,LUFTA
AFINU=FAUNI
AĂFNU=FAUNĂ
AEFNU=FAUNE
AFIRU=FAURI
AFORV=FAVOR
AFSUV=FAVUS
AAFNZ=FAZAN
ĂĂCFU=FĂCĂU
ĂCFTU=FĂCUT
AĂFGŞ=FĂGAŞ
ĂEFGT=FĂGET
ĂĂFIN=FĂINĂ
ĂFLOS=FĂLOS
AĂFRŞ=FĂRAŞ
AĂFMR=FĂRMA,MARFĂ
ĂFISU=FĂSUI
ĂEFIŞ=FĂŞIE
ĂFIIŞ=FĂŞII
AĂFTT=FĂTAT,TAFTĂ
ĂFIOT=FĂTOI
ĂFIŞŢ=FĂŢIŞ
ĂFIŢU=FĂŢUI
ĂFIRU=FĂURI,RĂFUI
ĂBEFR=FEBRĂ
DEEFR=FEDER
AEFHL=FELAH
EEFIL=FELIE,FILEE
EFIIL=FELII
EFILN=FELIN,FENIL
EFLNO=FELON,FENOL
EEFIM=FEMEI
EFMRU=FEMUR
CEEFN=FENEC
CEFIN=FENIC
EFINX=FENIX
ĂEFNT=FENTĂ
EEFNT=FENTE
EFIRT=FERIT,FIERT,FIRET
ĂEFMR=FERMĂ
EFIMR=FERMI,FIRME
EEFMR=FERME
EFORS=FEROS
ĂEFST=FESTĂ
EEFST=FESTE
DEFIT=FETID
EEFIT=FETIE
EFIŞT=FETIŞ
EFRTU=FETRU,TRUFE
EFSTU=FETUS,FUSTE
ĂDEFU=FEUDĂ
DEEFU=FEUDE
AĂFIR=FIARĂ
AEFIR=FIARE,RAFIE
ĂBFIR=FIBRĂ
BEFIR=FIBRE
CFISU=FICUS
DEFIL=FIDEL
DEFIR=FIDER
CEEFI=FIECE
EEFIR=FIERE
CEFIS=FIESC
ĂCFII=FIICĂ
CEFII=FIICE
EFILT=FILET,LIFTE,TIFLE
EFILU=FILEU,FULIE
EFILM=FILME,LIMFE
AFILM=FILMA
FILNO=FILON
AFILN=FINAL
EFINT=FINET
FIINŞ=FINIŞ
FIINT=FINIT
ĂFILO=FIOLĂ
EFILO=FIOLE,FOLIE
CFINO=FIONC,FONIC
FGINO=FIONG
FIIOR=FIORI,FOIRI,ROFII
DFIOR=FIORD
AFIRV=FIRAV
EFIRZ=FIREZ,FRIZE,ZEFIR
FIIRZ=FIRIZ
ĂFIMR=FIRMĂ
FIORS=FIROS
FIRŢU=FIRUŢ
ĂCFIŞ=FIŞCĂ
FIIŞT=FIŞTI
CFIIŞ=FIŞIC,FICŞI
FIIŞU=FIŞIU
FIILT=FITIL
FIITU=FITUI
FIIŢU=FIUŢI
AFIJX=FIXAJ
AFITX=FIXAT
CFIIZ=FIZIC
AÂFNR=FÂNAR,FRÂNA
AÂFNŢ=FÂNAŢ
ĂÂFIS=FÂSĂI
ÂÂFIS=FÂSÂI
ĂÂFIŞ=FÂŞĂI
ÂEFIŞ=FÂŞIE
ÂFIIŞ=FÂŞII
ÂÂFIŞ=FÂŞÂI
ÂÂFIŢ=FÂŢÂI
AĂFLM=FLAMĂ
AEFLM=FLAME
AEFLN=FLANE
ACFLN=FLANC
ACFLS=FLASC
AFHLS=FLASH
EFLOŞ=FLEOŞ
ĂEFLŞ=FLEŞĂ
EEFLŞ=FLEŞE
FILNT=FLINT
FILRT=FLIRT
FILOR=FLORI
CFILO=FLOCI
ĂFLOR=FLORĂ
AFLOT=FLOTA
ĂFLOT=FLOTĂ
EFLOT=FLOTE,FOTEL,OTFEL
AFJLU=FLUAJ
ĂDFLU=FLUDĂ
DEFLU=FLUDE
DFILU=FLUID
FLORU=FLUOR
ACFIO=FOACI
AEFIO=FOAIE
AEFLO=FOALE
AEFMO=FOAME
BEFIO=FOBIE
BFIIO=FOBII
ACFLO=FOCAL
ACFOR=FOCAR
CFOOS=FOCOS
ĂDFOR=FODRĂ
DEFOR=FODRE
EEFNO=FOENE
FIOOS=FOIOS
ĂFIOŢ=FOIŢĂ
EFIOŢ=FOIŢE
AFILO=FOLIA
FIILO=FOLII,FOLII,OFILI
FILOO=FOLIO
FILOU=FOLIU
FLOOS=FOLOS
ADFNO=FONDA
EFMNO=FONEM
FFINO=FONFI
EFINO=FONIE
FNNOO=FONON
ĂFNOT=FONTĂ
EFNOT=FONTE
AFJOR=FORAJ,FORJA
ĂFIOR=FORĂI
ĂFJOR=FORJĂ
EFJOR=FORJE
ĂFMOR=FORMĂ
EFMOR=FORME
AFORŢ=FORŢA
ĂFORŢ=FORŢĂ
EFORŢ=FORŢE
FILOS=FOSIL
ĂFOST=FOSTĂ
FIOŞT=FOŞTI
EFOST=FOSTE,OFSET
ĂFIOŞ=FOŞĂI
FINOŞ=FOŞNI
FNOOT=FOTON
CFIOŞ=FOCŞI
AFGIR=FRAGI,GRAFI
AĂFGR=FRAGĂ
AFHRT=FRAHT
ACFNR=FRANC
AFJNR=FRANJ
AFNRŞ=FRANŞ
AAFPR=FRAPA
AEFRT=FRATE,FRETA
AFIRŢ=FRAŢI
AAFRZ=FRAZA,ZARAF
AĂFRZ=FRAZĂ
AEFRZ=FRAZE,FREZA
ĂEFRT=FRETĂ
EEFRT=FRETE,TERFE
ĂEFRZ=FREZĂ
EEFRZ=FREZE
CFIIR=FRICI
EFGIR=FRIGE,GRIFE
FIPRT=FRIPT
AFIRZ=FRIZA,ZARIF
ĂFIRZ=FRIZĂ
ĂÂFNR=FRÂNĂ
ÂEFNR=FRÂNE
ÂCFNR=FRÂNC
ÂFNRT=FRÂNT
ÂEFIR=FRÂIE
FNORT=FRONT
CFRTU=FRUCT
FPRTU=FRUPT
FRSTU=FRUST
FIORT=FTORI
CFSUU=FUCUS
DFLUU=FUDUL
FGITU=FUGIT
FGOSU=FUGOS
FGIUU=FUGUI
FIORU=FUIOR,OFURI
AFLRU=FULAR,LUFAR
EFLUU=FULEU
EEFLU=FULEE
FGILU=FULGI
FIILU=FULII
AFMRU=FUMAR
FIMUU=FUMUI
ĂDFNU=FUNDĂ,NĂDUF
DEFNU=FUNDE
ĂFGNU=FUNGĂ
FGINU=FUNGI
EFINU=FUNIE
FIINU=FUNII
FINŢU=FUNŢI
AFJRU=FURAJ
AFNRU=FURAN
AFRTU=FURAT,TUFAR
ADFRU=FURDA
EFIRU=FURIE
FIIRU=FURII
FIRŞU=FURIŞ
FORUU=FUROU
AFRSU=FUSAR
FINUZ=FUNZI
ĂFSTU=FUSTĂ
EFŞTU=FUŞTE
FIŞTU=FUŞTI,TUFIŞ
FILTU=FUTIL,TUFLI
EEFUZ=FUZEE
EFLUZ=FUZEL
EFNUZ=FUZEN
ABEGI=GABIE,GAIBE
ABGII=GABII
ACGGI=GAGIC
AGGIU=GAGIU
AGGII=GAGII
AĂCGI=GAICĂ
ĂCGII=GĂICI
AĂDGI=GAIDĂ
ADEGI=GAIDE
AĂGIŢ=GAIŢĂ
AEGIŢ=GAIŢE
AEGLŞ=GALEŞ
AEGLT=GALET,LEGAT
ACGIL=GALIC
AGILŞ=GALIŞ
AGILU=GALIU
AGLNO=GALON,GOLAN
AGLOP=GALOP
AGLOŞ=GALOŞ,GOLAŞ
AĂBGM=GAMBĂ
ABEGM=GAMBE
AEGMT=GAMET,TAGME
AĂGGN=GANGĂ
AEGGN=GANGE
AAGJR=GARAJ
ĂGIRZ=GĂRZI
AĂCGŞ=GAŞCĂ
ĂGIŞT=GĂŞTI
AEGRT=GATER,REGAT,TRAGE
AĂGRU=GAURĂ
ĂGIRU=GĂURI,GURĂI,IUGĂR
AGSSU=GAUSS
AGIŞU=GAUŞI
AAGTZ=GAZAT
AĂDGZ=GAZDĂ
ADEGZ=GAZDE
AEGLZ=GAZEL
AGNOZ=GAZON
AGOSZ=GAZOS
ĂBGIJ=GĂBJI
ĂBGIU=GĂBUI
AĂGIN=GĂINA
ĂĂGIN=GĂINĂ
ĂGIIN=GĂINI,GĂINI
AĂGMN=GĂMAN
ĂCGIO=GĂOCI
ĂGIST=GĂSIT
AĂGTT=GĂTAT
ĂEGJT=GĂTEJ
ĂGITT=GĂTIT
AĂGNV=GĂVAN
AĂGRZ=GĂZAR,RĂGAZ
AĂEGN=GEANĂ,NEAGĂ
EGINŢ=GENŢI
EEGLP=GELEP
EGILV=GELIV
EGLOS=GELOS,GLOSE
EGILU=GELUI,GULIE
ĂEGMT=GEMĂT
EEGMN=GEMEN
EEGMT=GEMET
EGMTU=GEMUT,MUGET
EGINU=GENIU
EGIIN=GENII
EGLNO=GENOL
ĂDEGO=GEODĂ
DEEGO=GEODE
DEGIO=GEOID
AEGHR=GERAH
AEGRR=GERAR
EEGRT=GERET
DEGIR=GERID
EGORS=GEROS
EGIRU=GERUI,GRUIE,URGIE
CEGIT=GETIC
EEGHT=GHETE
BEEGH=GHEBE
ĂBEGH=GHEBĂ
EEGHM=GHEME
EGHOT=GHETO
CGHII=GHICI
ĂDGHI=GHIDĂ
GHIIZ=GHIZI
DEGHI=GHIDE
ADGHI=GHIDA
DGHII=GHIDI
GHIIL=GHILI
GHINT=GHINT
GHINŢ=GHINŢ
BGHIO=GHIOB
CGHIO=GHIOC
GHILO=GHIOL
GHIOŞ=GHIOŞ
GHIPS=GHIPS
GHIJU=GHIUJ
DGHIZ=GHIZD
BGINO=GIBON
AEGGI=GIGEA
ĂGINT=GINTĂ
GIINŢ=GINŢI
ÂÂFGI=GÂFÂI
ÂÂGGI=GÂGÂI
ĂÂCGL=GÂLCĂ
ÂCGIL=GÂLCI
ĂÂGLM=GÂLMĂ
ÂEGLM=GÂLME
ÂDGIN=GÂNDI
ĂÂGLR=GÂRLĂ
ÂEGLR=GÂRLE
AÂGRT=GÂTAR
ÂGOST=GÂTOS
ÂGITU=GÂTUI
AGLNŢ=GLANŢ
AAGLS=GLASA
AGLST=GLAST
GILMO=GLIOM,MILOG
AGILS=GLISA
BGILO=GLOBI,GLOBI
DGILO=GLODI
GLNOŢ=GLONŢ
AGLOS=GLOSA
ĂGLOS=GLOSĂ
ĂGLOT=GLOTĂ
EGLOT=GLOTE
ĂGGLU=GLUGĂ
GGILU=GLUGI
ĂGLMU=GLUMĂ
EGLMU=GLUME,MULGE
GILMU=GLUMI
AGINS=GNAIS
GIMNO=GNOMI
AEGNO=GOANE
ACDGO=GODAC
DEGNO=GODEN
DEGOU=GODEU
AFGOR=GOFRA
AĂGLO=GOALĂ
AEGLO=GOALE
GLOŢU=GOLUŢ
GMOOS=GOMOS
AGNOŞ=GONAŞ
ACGOP=GOPAC
GNORU=GORUN
ĂCGOT=GOTCĂ
CEGOT=GOTCE
CGIOT=GOTIC
ADGJR=GRAJD
AEGMR=GRAME
AĂGPR=GRAPĂ,GRĂPA
AEGPR=GRAPE
AĂGRS=GRASĂ
AEGRS=GRASE,GRESA
AGRRU=GRAUR
AĂGRV=GRAVĂ,VARGĂ,VĂRGA
AGIRV=GRAVI
AEGRV=GRAVE,GREVA
AAGRV=GRAVA
CEEGR=GRECE
AEFGR=GREFA
ĂEFGR=GREFĂ
EEFGR=GREFE
EGIOR=GREOI,ORGIE
EGIRŞ=GREŞI
EEGLR=GRELE
ĂEGRV=GREVĂ,VERGĂ
EEGRV=GREVE
EGIRR=GRIER
ĂFGIR=GRIFĂ
ĂGIJR=GRIJĂ
GIIJR=GRIJI
ĂGILR=GRILĂ,LĂRGI,RIGLĂ
EGILR=GRILE,RIGLE
AGIMR=GRIMA,MIGRA
ĂGIMR=GRIMĂ
EGIMR=GRIME,REGIM
DGINR=GRIND
ĂGIPR=GRIPĂ
EGIPR=GRIPE
ĂGIRV=GRIVĂ,VĂRGI
GIIRV=GRIVI
EGIRV=GRIVE,VERGI,VERGI
AGIRZ=GRIZA
GIRUZ=GRIZU
ÂEGNR=GRÂNE
ÂEGIR=GRÂIE
GIOPR=GROPI
FGIOR=GROFI
GIMOR=GROMI,MORGI
GIORŞ=GROŞI,GROŞI
ĂGORT=GROTĂ
EGORT=GROTE
DGNRU=GRUND
GNRUZ=GRUNZ
AGPRU=GRUPA
ĂGPRU=GRUPĂ
EGPRU=GRUPE
AGNOU=GUANO
ADGRU=GUARD
AĂGŞU=GUAŞĂ
AEGŞU=GUAŞE
ABGUV=GUBAV
EFGLU=GUELF
AGIŢU=GUIŢA
AGLŞU=GULAŞ
EGLRU=GULER
GIILU=GULII
AGJMU=GUMAJ
AGMTU=GUMAT
GINOU=GUNOI
EGRŞU=GUREŞ
ĂGMRU=GURMĂ,MURGĂ
EGMRU=GURME,MURGE
GRTUU=GURUT
AGSTU=GUSTA
AGŞTU=GUŞAT
GOSTU=GUTOS
GITUU=GUTUI,UGUIT
DGIUV=GUVID
ĂGLUZ=GUZLĂ,ZĂLUG
EGLUZ=GUZLE
AABHR=HABAR
ADEHS=HADES
AGHIU=HAGIU
AGHII=HAGII
AAHHM=HAHAM
AADHI=HAIDA
ADEHI=HAIDE
AĂHIN=HAINĂ
AHIIN=HAINI
AEHIN=HAINE
AĂHIT=HAITĂ
AEHIT=HAITE
AHIIT=HAITI
AAHJL=HALAJ
AAHLL=HALAL
AAHLT=HALAT
AĂHLU=HALĂU
AĂBHL=HALBĂ
AACHL=HALCA
AĂDHL=HALDĂ
ADEHL=HALDE
AFHIL=HALFI
AHILT=HALIT
AĂHLT=HALTĂ
AEHLT=HALTE
AAHLV=HALVA,VALAH
AACHM=HAMAC
AAHLM=HAMAL
AEHIM=HAMEI
AHIMŞ=HAMIŞ
AHMTU=HAMUT
AAHNT=HANAT
AĂHNS=HANSĂ
AEHNS=HANSE
AĂHNŢ=HANŢĂ
AEHNŢ=HANŢE
AĂCHP=HAPCĂ
ACHIP=HAPCI
AEHLP=HAPLE
AACHR=HARAC
AAGHR=HARAG
AAHMR=HARAM
AAHPR=HARAP
AEHMR=HAREM
AĂFHR=HARFĂ
AEFHR=HARFE
AĂHPR=HARPĂ
AEHPR=HARPE,HEPAR
AAHRŞ=HARŞA
AĂHRT=HARTĂ
ĂHIRŢ=HĂRŢI
AĂHRŢ=HARŢĂ
AHIRŢ=HARŢI
AĂCHS=HASCĂ
AĂCHŞ=HAŞCĂ
ĂHIŞT=HĂŞTI
AHIŞŞ=HAŞIŞ
AĂHMŞ=HAŞMĂ
AEHMŞ=HAŞME
AÂHRT=HATÂR
AAHNV=HAVAN
AĂHRV=HAVRĂ
AEHRV=HAVRE
AHUVZ=HAVUZ
AAHNZ=HAZNA
AĂHNZ=HAZNĂ
AEHNZ=HAZNE
ĂBCHU=HĂBUC
ĂCHIU=HĂCUI
ĂHIIN=HĂINI
ĂEHIR=HĂIRE
ĂHIIR=HĂIRI
AĂHIS=HĂISA
ĂĂHIT=HĂITĂ
ĂEHIT=HĂITE
ĂHIIŢ=HĂIŢI
ĂĂHIM=HĂMĂI
ĂEHIM=HĂMEI,MEHĂI
ĂHIMU=HĂMUI
ĂĂHIP=HĂPĂI
AĂHŞŢ=HĂŢAŞ
ĂHIŞŢ=HĂŢIŞ
ĂHIŢU=HĂŢUI,ŢUHĂI
ĂHIRU=HĂURI
ĂHITU=HĂUIT
ĂHILU=HĂULI,HUILĂ
CEHHT=HECHT
DEEHR=HEDER
EEHHI=HEHEI
EEGHL=HELGE,LEGHE
EGHIL=HELGI
EHILO=HELIO
EHILU=HELIU,HUILE
EHINR=HENRI
EEHMR=HERME
EHRTZ=HERTZ
EHLRU=HERUL
AEEHV=HEVEA
AEHNX=HEXAN
DHIOS=HIDOS
ĂDHIR=HIDRĂ
DEHIR=HIDRE
ĂEHIN=HIENĂ
EEHIN=HIENE
BEHIR=HIERB
AHILR=HILAR
AEHIL=HILEA
EHIMN=HIMEN
DHIIN=HINDI
DHIIO=HIOID
ĂHILO=HIOLĂ
EHIPR=HIPER
CHIIP=HIPIC
ĂHIRT=HIRTĂ
EHIRT=HIRTE
HIITT=HITIT
ÂÂCHI=HÂCÂI
ĂÂHIT=HÂITĂ
ÂHIIŢ=HÂIŢI
ÂEHIT=HÂITE
ÂÂHIM=HÂMÂI
ĂÂHRU=HÂRĂU
ĂÂHIR=HÂRĂI
ĂÂCHR=HÂRCĂ
ÂCHIR=HÂRCI
ÂÂHIR=HÂRÂI
ÂHIRS=HÂRSI
ĂÂHRŢ=HÂRŢĂ
ÂHIRŢ=HÂRŢI
ĂÂHIŞ=HÂŞĂI
ÂÂHIŞ=HÂŞÂI
ÂHRTU=HÂTRU
ĂÂHRT=HÂTRĂ
ÂHIRT=HÂTRI
ÂEHRT=HÂTRE
ÂÂHIŢ=HÂŢÂI
HIILZ=HLIZI
ABHNO=HOBAN
ÂBCHO=HOBÂC
BHOOT=HOBOT
AGHOŞ=HOGAŞ
AEGHO=HOGEA
EHHOR=HOHER
HHOOT=HOHOT
AHJMO=HOJMA
ĂHJMO=HOJMĂ
ABHLO=HOLBA
ĂDHLO=HOLDĂ
DEHLO=HOLDE
AHMOR=HOMAR
HINOU=HONUI
AHIOP=HOPAI
ĂHIOP=HOPĂI
ĂHIOR=HORĂI
ĂDHOR=HORDĂ
DEHOR=HORDE
EHORŢ=HOREŢ
HORST=HORST
AHORT=HOTAR
EHLOT=HOTEL
AĂHOŢ=HOAŢĂ
AEHOŢ=HOAŢE
EHIOŢ=HOŢIE
HIIOŢ=HOŢII
HIOŞŢ=HOŢIŞ
HIOTŢ=HOŢIT
AĂHNR=HRANĂ
AEHNR=HRANE,HREAN
ĂHINR=HRĂNI
ĂHIPR=HRĂPI
BHIIR=HRIBI
ĂBHRU=HRUBĂ
BEHRU=HRUBE
EHITU=HUIET,TEHUI
AHIŢU=HUIŢA
EHLPU=HULPE
HILPU=HULPI
BHLUU=HULUB
HILUU=HULUI
HMORU=HUMOR
HMOSU=HUMOS
HIMUU=HUMUI
HMSUU=HUMUS
AHLRU=HURAL
EHRUZ=HUREZ
EHIRU=HURIE
HIIRU=HURII
HNORU=HURON
ĂHRTU=HURTĂ
EHRTU=HURTE
HIRUU=HURUI
AHRSU=HUSAR
ĂHSŞU=HUSĂŞ
ĂCHSU=HUSCĂ
HIŞTU=HUŞTI,HUŞTI
HISTU=HUSIT
HOSŞU=HUSOŞ
EHŞTU=HUŞTE
AHNŢU=HUŢAN
HLŢUU=HUŢUL
HRUUZ=HUZUR
ADEIŞ=IADEŞ
AĂBIR=IARBĂ
AĂINR=IARNĂ
EIINR=IERNI,RENII
AAIŞV=IAVAŞ
EEIMZ=IEZME,ZMEIE
BIIIŞ=IBIŞI
CEIRT=ICTER,TERCI
CISTU=ICTUS
ĂDIIL=IDILĂ
DIIOT=IDIOT
DEIŢU=IEDUŢ
AEINR=IERNA
EEILS=IESLE
AĂIST=IASTĂ,IASTĂ
EIIŞT=IEŞTI,IEŞIT
EEIST=IESTE
EFIOS=IFOSE
AGINR=IGNAR
AGINT=IGNAT
AĂILR=ILARĂ
AIILR=ILARI,RIALI
AEILR=ILARE,IREAL,REALI
AEIIL=ILAIE
EILNO=ILEON
EILSU=ILEUS
CEIIL=ILICE,LEICI
IILNO=ILION
ĂIILR=ILIRĂ
IIILR=ILIRI
EIILR=ILIRE
IILOŢ=ILOŢI
IIMRU=IMURI,MIRUI
AGIMO=IMAGO,OMAGI
AIIMM=IMAMI
AIIMN=IMANI,MANII
EIMNS=IMENS
AIIMT=IMITA
IIMOŞ=IMOŞI,MOŞII,OMIŞI
AIMPR=IMPAR
AIMPS=IMPAS
IMPRU=IMPUR
ĂIMNU=IMUNĂ
IIMNU=IMUNI,MINIU,UNIMI
EIMNU=IMUNE,MENIU,UNIME
DIMNU=IMUND
AINPT=INAPT
ACINS=INCAS
DEINX=INDEX
CDIIN=INDIC
DIINU=INDIU
DINSU=INDUS
EEINŢ=INEŢE
ĂEIMN=INEMĂ
EEIMN=INEME
EINPT=INEPT
EIMNR=INERM,MINER
EINRT=INERT,INTER,TERNI
AFIMN=INFAM
FIIMN=INFIM
FIINX=INFIX
ĂCIIN=INICĂ
CIIIN=INICI
CEIIN=INICE
ĂIIMN=INIMĂ,NĂIMI
IIIMN=INIMI
EIIMN=INIME,MINEI
IINNO=INION
ĂIINŢ=INIŢĂ
IIMNT=INTIM
AINRT=INTRA,NITRA,TIRAN
IINTU=INTUI,NITUI
AINRV=INVAR,VINAR,VIRAN
ABGIO=IOBAG
ADIOT=IODAT
ĂCFIO=IOFCĂ
CIINO=IONIC,OCINI
IINOU=IONIU
IOPSS=IPSOS
IIRRU=IRURI
BIIRS=IRBIS
AGIIR=IRIGA
AIIRT=IRITA
ĂIIRT=IRITĂ,TĂRII
EIIRT=IRITE
IMORS=IRMOS,MIROS
IIORZ=IROZI,ROZII
IIORS=IROSI
AILMS=ISLAM
AILSZ=ISLAZ
AFINS=ISNAF
IIOPS=ISOPI
AIPSS=ISPAS
ILOPS=ISPOL
EISTŢ=ISTEŢ
IOSTV=ISTOV
CIILŞ=IŞLIC
AIINŢ=IŢANI,NAŢII
AIIRŢ=IŢARI,RAŢII
IIIŢU=IŢIIU
BEIŢU=IUBEŢ
DEIUU=IUDEU
DEIIU=IUDEI
EIILU=IULIE
EIINU=IUNIE
ĂIRŞU=IURĂŞ
EIRŞU=IUREŞ,REUŞI,UŞERI,UŞIER
ĂIRTU=IURTĂ,TĂURI
EIRTU=IURTE,TEURI
IRŞUU=IURUŞ
ĂCIŞU=IUŞCĂ
IIŞTU=IUŞTI
IITŢU=IUŢIT,ŢIUIT
ĂITUX=IUXTĂ
EITUX=IUXTE
ĂEIRV=IVĂRE
EIIRV=IVIRE,VIERI
IIRUZ=IZURI
BCIUZ=IZBUC
AILZZ=IZLAZ
AILOZ=IZOLA
DIOVZ=IZVOD
IORVZ=IZVOR,VIZOR
ABIÎM=ÎMBIA
ABÎLM=ÎMBLA
EÎLMP=ÎMPLE
AÎLNT=ÎNALT
ACIÎN=ÎNCAI
CEÎNT=ÎNCET
ÂCÎNT=ÎNCÂT
ACÎNO=ÎNCOA
CÎNOT=ÎNCOT
DIÎNO=ÎNDOI
ACEÎN=ÎNECA
AFIÎN=ÎNFIA
EGÎNR=ÎNGER
IIÎMN=ÎNMII
IÎNNO=ÎNNOI
AÎNOT=ÎNOTA
ĂIÎNR=ÎNRĂI
ÂIÎNT=ÎNTÂI
AÎNRT=ÎNTRA
EÎNRT=ÎNTRE
ÎNRTU=ÎNTRU
ĂÎNŢV=ÎNVĂŢ
AIÎNV=ÎNVIA
IÎNOV=ÎNVOI
ABJOU=JABOU
AĂBJR=JABRĂ
AACJŞ=JACAŞ
AĂBJL=JALBĂ
ABEJL=JALBE
AEJLŞ=JALEŞ
AEJLT=JALET
AJLNO=JALON
AĂBJM=JAMBĂ
ABEJM=JAMBE
AĂJNT=JANTĂ
AEJNT=JANTE,JENAT
AĂCJP=JAPCĂ
AJNOP=JAPON
AĂJPŞ=JAPŞĂ
AEJPŞ=JAPŞE
ĂIJPŞ=JĂPŞI
AĂCJR=JARCĂ
ĂCIJR=JĂRCI
AĂDJR=JARDĂ
ADEJR=JARDE
AEJRT=JARET
AEJLV=JAVEL
AĂJRV=JAVRĂ,VRAJĂ
AEJRV=JAVRE
AĂCJŞ=JĂCAŞ
ĂIJRU=JĂRUI
DEIJR=JDERI
CEIJU=JECUI
EFIJU=JEFUI
EGJOS=JEGOS
EJJNU=JEJUN
EEJLR=JELER,LEJER
EEJLU=JELEU
EIJLT=JELIT
EIJLU=JELUI
ĂBEJR=JERBĂ
BEEJR=JERBE
EEJRS=JERSE
EIJRU=JERUI
EJNOT=JETON
AĂIJN=JIANĂ
EIIJN=JIENI
EEIJN=JIENE
CIIJN=JICNI
ADIJN=JIDAN
DIJOV=JIDOV
ĂGIJL=JIGLĂ
EGIJL=JIGLE
GIIJN=JIGNI
GIJOU=JIGOU
AIJLV=JILAV
IIJLP=JILIP
ABIJM=JIMBA
AIJNP=JIPAN
AIJPT=JIPAT
AIJRT=JITAR,TIRAJ,TRIAJ
EIIJT=JITIE
IIIJT=JITII
BEJNO=JOBEN
CJOOT=JOCOT
CJOŢU=JOCUŢ
EJKOR=JOKER
ĂCJNO=JONCĂ
CIJNO=JONCI
AĂJOS=JOASĂ
AEJOS=JOASE
EJLOU=JOULE
IJLOU=JOULI
ACJTU=JUCAT
CDEJU=JUDEC
DEJŢU=JUDEŢ
AGJNU=JUGAN
ĂGJRU=JUGĂR
AIJSU=JUISA
ĂJJUU=JUJĂU
EJJUU=JUJEU
ĂFJLU=JULFĂ
EFJLU=JULFE
IJLTU=JULIT
CIJNU=JUNCI,JUNCI
ĂCJNU=JUNCĂ
EJLNU=JUNEL
EIJNU=JUNEI,JUNIE
ĂJNTU=JUNTĂ
EJNTU=JUNTE
AJNPU=JUPAN
IJPTU=JUPIT
ÂJNPU=JUPÂN
JNOPU=JUPON
IJPUU=JUPUI
AJRTU=JURAT
IJRUU=JURIU,JURUI
IIJRU=JURII
ĂJSTU=JUSTĂ
IJŞTU=JUŞTI
EJSTU=JUSTE
ĂJŢUV=JUVĂŢ
ĂJTUX=JUXTĂ
EJTUX=JUXTE
AIKKU=KAKIU
AEIKK=KAKIE
AIKLU=KALIU
AAHKZ=KAZAH
DEIKV=KEDIV
EHKMR=KHMER
ĂDKRU=KURDĂ
IKRUZ=KURZI
DEKRU=KURDE
ABILL=LABIL
AĂCLT=LACĂT,LĂCAT
ACLMO=LACOM
ACLOT=LACTO,OCTAL
AĂGLR=LAGĂR,LARGĂ
AĂILT=LAITĂ
AAELL=LALEA
AĂBLM=LAMBĂ
ABELM=LAMBE
ĂILMP=LĂMPI
AĂDLN=LANDĂ
ADELN=LANDE
AALNS=LANSA
AILPS=LAPIS
ALNOP=LAPON,NOPAL
AELPT=LAPTE
AILPŢ=LAPŢI
AGILR=LARGI
AAGLR=LARGA
AGLOR=LARGO
AĂLMR=LARMĂ
AELMR=LARME
AĂLRV=LARVĂ,LAVRĂ
AELRV=LARVE,LAVRE,VELAR
AELRS=LASER
ALOSU=LASOU
AELTX=LATEX
AILRT=LATIR,TRIAL
AILRU=LAURI,RALIU
AILUV=LAVIU,VALIU
AĂCLŞ=LĂCAŞ
ĂĂFIL=LĂFĂI
ĂEILŞ=LĂIEŞ
ĂEILŢ=LĂIEŢ,LEIŢĂ
ĂĂILL=LĂLĂI
ĂÂLLU=LĂLÂU
ĂÂILL=LĂLÂI
ĂÂILM=LĂMÂI
ĂĂILP=LĂPĂI
AĂLST=LĂSAT
ĂCLOT=LĂTOC,LOTCĂ
AĂLRT=LĂTRA
ĂILŞŢ=LĂŢIŞ
ĂILTŢ=LĂŢIT
ĂLOSŢ=LĂŢOS
ĂĂLTU=LĂUTĂ
ĂELTU=LĂUTE,LUETĂ
ĂĂLUZ=LĂUZĂ
ĂELUZ=LĂUZE
ĂILUZ=LĂUZI
AĂEFL=LEAFĂ
AĂEHL=LEAHĂ
AĂELL=LEALĂ
AEILL=LEALI
AEELL=LEALE
EELPŞ=LEPŞE
AĂELS=LEASĂ
CEILT=LECIT,LETCI
EFILŢ=LEFŢI
AEGLL=LEGAL
CEGIL=LEGIC
ĂEHIL=LEHĂI,LEHĂI
ĂEHLU=LEHĂU
ĂCEIL=LEICĂ
EIILŢ=LEIŢI
EEILŢ=LEIŢE
EELMN=LEMNE
AEJLN=LENAJ
EELNŞ=LENEŞ
ELNOS=LENOS
ĂELNT=LENTĂ
EILNŢ=LENŢI,NIŢEL
EELNT=LENTE
ELNOT=LENTO,LETON
ĂEILP=LEPĂI
ĂELPR=LEPRĂ
EELPR=LEPRE
EILPŞ=LEPŞI
EILPU=LEPUI,LUPIE
EILOR=LEROI
EILRU=LERUI
EELNS=LESNE
AELST=LESTA,TESLA
EEILŞ=LEŞIE
EILNŞ=LEŞIN
EILŞU=LEŞUI
AELLT=LETAL,TELAL
EILŢU=LEUŢI,ULIŢE
EELMX=LEXEM
CEILX=LEXIC
AĂILN=LIANĂ
CIILT=LICIT
CILRU=LICUR
ĂFILT=LIFTĂ,TIFLĂ
AGILV=LIGAV
ĂHIIL=LIHĂI
HIILN=LIHNI
AILMN=LIMAN,MALIN
AILMX=LIMAX
ABILM=LIMBA
ĂBILM=LIMBĂ
BIILM=LIMBI
EILMS=LIMES
ĂFILM=LIMFĂ
EGILN=LINGE
IIILN=LINII
ILNNO=LINON
ILNOU=LINOU
ĂILNS=LINSĂ
IILNŞ=LINŞI
EILNS=LINSE
AILNŞ=LINŞA
EILNT=LINTE
IILNŢ=LINŢI
ĂILOT=LIOTĂ
ĂIILP=LIPĂI
EIILP=LIPIE
IIILP=LIPII
IILPT=LIPIT
ILMOP=LIPOM
ĂILPS=LIPSĂ
EILPS=LIPSE
IILPS=LIPSI
CIILR=LIRIC
ĂILST=LISTĂ
EILST=LISTE
IIILT=LITII
IILTU=LITIU,UTILI
ĂILRT=LITRĂ
EILRT=LITRE
ILRTU=LITRU,RUTIL
IILRT=LITRI
AILNV=LIVAN
DIILV=LIVID
AILRV=LIVRA,RIVAL
ĂILRV=LIVRĂ,VRILĂ
EILRV=LIVRE,VRILE
ILLOZ=LIZOL
ĂÂGLN=LÂNGĂ
ÂLNOS=LÂNOS
AĂLOZ=LOAZĂ
AELOZ=LOAZE
ABLOR=LOBAR
ĂBDLO=LOBDĂ,LODBĂ
BDELO=LOBDE,LODBE
BLLOU=LOBUL
ACLLO=LOCAL
ACLOŞ=LOCAŞ
ĂCLMO=LOCMĂ
DELNO=LODEN
ELOSS=LOESS
CGILO=LOGIC
GLOOS=LOGOS
AILLO=LOIAL
ĂJLNO=LONJĂ
EJLNO=LONJE
ILORZ=LORZI
LNOOT=LOTON
LORTU=LOTRU
ILORT=LOTRI
LOSTU=LOTUS,LUTOS
EILOZ=LOZIE
IILOZ=LOZII
CILUU=LUCIU,ULUCI
EELTU=LUETE
GLLOU=LUGOL
EJLRU=LUJER
AELLU=LULEA
ELMNU=LUMEN
ELMŢU=LUMEŢ
ALNRU=LUNAR
ĂCLNU=LUNCĂ
CILNU=LUNCI
ĂGLNU=LUNGĂ
GILNU=LUNGI
ALNPU=LUPAN
ILNPU=LUPIN,NIPLU
ILPUU=LUPIU
IILPU=LUPII
ILOPU=LUPOI
ALPTU=LUPTA
ĂLPTU=LUPTĂ
ELPTU=LUPTE
LPSUU=LUPUS
ELRUX=LUREX
ĂLRTU=LUTRĂ,TURLĂ
ELRTU=LUTRE,TELUR,TURLE,URLET
LRTUU=LUTRU
ILTUU=LUTUI,TULIU,ULUIT
CILŞU=LUCŞI
LOSUX=LUXOS
AACCM=MACAC
AACMT=MACAT
ACHIM=MACHI
AADMM=MADAM
AADEM=MADEA
ACGIM=MAGIC
AEGIM=MAGIE
AGIIM=MAGII
AĂGMM=MAGMĂ
AEGMM=MAGME
AGMOT=MAGOT
AĂHMR=MAHĂR
AHMNO=MAHON,MONAH
AAILM=MAIAL
AEIMU=MAIEU
AIMOU=MAIOU
AJMOR=MAJOR,MOJAR
AAMMR=MAMAR
ABMMO=MAMBO
AMMOŞ=MAMOŞ
AMMTU=MAMUT
AĂCMN=MANCĂ
ACEMN=MANCE
ACMNO=MANCO,MOCAN,MONAC
AEJMN=MANEJ,MENAJ
AĂMNŞ=MANŞĂ
AEMNŞ=MANŞE
AĂMNT=MANTĂ,MĂNAT
AAMRZ=MARAZ
AACMR=MARCA
AADMR=MARDA
ADIMR=MARDI
AEEMR=MAREE
AIMNR=MARIN
AĂJMR=MARJĂ,MĂJAR
AEJMR=MARJE
AĂMNR=MARNĂ
AEMNR=MARNE
AEMRT=MARTE,TRAME
AIMRŢ=MARŢI
AAJMS=MASAJ
AAMST=MASAT,TASMA
AACMS=MASCA
AĂCMS=MASCĂ
ĂIMŞT=MĂŞTI
AEMRS=MASER
AIMSV=MASIV
AĂLMS=MASLĂ
AELMS=MASLE
ALMSU=MASLU
AMNOS=MASON,OSMAN
AMORS=MASOR,OSRAM
AĂCMT=MATCĂ
ĂCIMT=MĂTCI
AMRTU=MATUR,MURAT
AĂMRU=MAURĂ
AIMRU=MAURI
AEMRU=MAURE
AIMMX=MAXIM
AILMZ=MAZIL
AMRUZ=MAZUR
ĂĂCIM=MĂCĂI
ĂCEMŞ=MĂCEŞ
AĂGMR=MĂGAR
ĂGIMU=MĂIUG
ĂIMŢU=MĂIUŢ
ĂEJMR=MĂJER,MREJĂ
ĂILMN=MĂLIN
ĂLMŢU=MĂLUŢ
ĂMNOS=MĂNOS
AĂMRR=MĂRAR
AĂMRZ=MĂRAZ,RAZĂM
ĂEMRŢ=MĂREŢ
ĂEIMR=MĂRIE
ĂIIMR=MĂRII
ĂIMRT=MĂRIT,MITRĂ
ĂIMOR=MĂROI
ĂMRŢU=MĂRUŢ
AĂIMS=MĂSAI
AĂMRS=MĂSAR,RĂMAS
AĂEMS=MĂSEA
ĂIMOS=MĂSOI,OMISĂ
AĂMRŢ=MĂŢAR
ĂCEIM=MECĂI
CEEMT=MECET,METEC
CDEIM=MEDIC
DEEIM=MEDIE
ĂDEJM=MEJDĂ
DEEJM=MEJDE
ELMNO=MELON
ELMOS=MELOS
EIMNT=MENIT,MINTE
EMNOU=MENOU
ĂEMNT=MENTĂ
AEMRR=MERAR
EEMRU=MEREU,UMERE
EEGMR=MERGE
EIMRS=MERSI
AEJMS=MESAJ
AEIMS=MESIA
AELMT=METAL
EILMT=METIL
EIMST=METIS,TEISM
DEMOT=METOD
EHMOT=METOH
ELMOT=METOL,MOLET,MOTEL
EMORT=METRO,TERMO
EMRTU=METRU,MUTRE,TURME
AEMTZ=MEZAT
EELMZ=MEZEL
EIMNZ=MEZIN
EMNOZ=MEZON
EEILM=MIELE
AIMNU=MIAUN,NUMAI,UMANI
AIMTU=MIAUT,MUIAT
CIMOR=MICRO,MIORC
CIMŢU=MICUŢ
DIIIM=MIDII
ĂGIMM=MIGMĂ
EGIMM=MIGME
EIIMM=MIIME
IIIMM=MIIMI
IIJMT=MIJIT
ILMOS=MILOS
IILMU=MILUI,UMILI
CIIMM=MIMIC
AIMNT=MINAT
EGIMN=MINGE
GIIMN=MINGI
IIMMN=MINIM
IMNOR=MINOR
ĂIMNT=MINTĂ
IIMNŢ=MINŢI,MINŢI
IMNSU=MINUS
IMNTU=MINUT,NUMIT
IIMNO=MIONI,NOIMI
IIMOP=MIOPI
IIMOR=MIORI
ĂIMOZ=MIOZĂ
AIJMR=MIRAJ
AIMRT=MIRAT,RITMA,TIMAR
AIMRZ=MIRAZ
IIMRŢ=MIRŢI,ŢIMIR
EIIMS=MISIE
IIIMS=MISII
IIMRS=MISIR
IIMST=MISIT
ACIMŞ=MIŞCA
EILMŞ=MIŞEL
AEIMŞ=MIŞEA
EIIMŞ=MIŞEI
IMOŞT=MIŞTO,MOŞTI,MOŞIT
IIMŞU=MIŞUI
IMNŞU=MIŞUN
CIIMT=MITIC
CIMOT=MITOC,TOCMI
IIMTU=MITUI,UIMIT
IMOSŢ=MIŢOS
IIMŢU=MIŢUI,MUŢII
AIJMX=MIXAJ
EIMRX=MIXER
ĂIMTX=MIXTĂ
EIMTX=MIXTE
EIMRZ=MIZER
ÂHIMN=MÂHNI
ÂEIMN=MÂINE,MÂNIE
ÂCILM=MÂLCI
ÂILMT=MÂLIT
ÂLMOS=MÂLOS
AÂMNŞ=MÂNAŞ
AÂMNT=MÂNAT
ÂIIMN=MÂINI,MÂNII
AÂCMN=MÂNCA
AÂEMN=MÂNEA
ÂEMNR=MÂNER
AÂIMN=MÂNIA
ÂIJMN=MÂNJI,MÂNJI
ÂIMNU=MÂNUI
ĂÂMNZ=MÂNZĂ
ÂEMNZ=MÂNZE
ÂÂIMR=MÂRÂI
ÂILMR=MÂRLI
ÂÂIMŞ=MÂŞÂI
ĂÂCMT=MÂTCĂ
ÂCIMT=MÂTCI
AÂMNŢ=MÂŢAN
ÂIMOŢ=MÂŢOI
ÂCMŢU=MÂŢUC
ĂÂGMZ=MÂZGĂ
AĂDLM=MLADĂ
ĂILMZ=MLĂZI
AĂJLM=MLAJĂ
ĂIJLM=MLĂJI
AELMO=MOALE
IMORŢ=MORŢI,MORŢI
AĂMOŞ=MOAŞĂ
AEMOŞ=MOAŞE
BILMO=MOBIL
ĂCIMO=MOCĂI
CIMNO=MOCNI
ADLMO=MODAL
DELMO=MODEL,MOLDE
CDIMO=MODIC
DMORU=MODRU
DLMOU=MODUL
HMOOR=MOHOR
ĂIMMO=MOIMĂ
EIMMO=MOIME
ĂIMNO=MOINĂ,MOINĂ,NOIMĂ
EIMNO=MOINE,MOINE,NOIME,OMENI
CIJMO=MOJIC
ALMNO=MOLAN
ALMOR=MOLAR,MOLAR,MORAL
ĂDLMO=MOLDĂ
DILMO=MOLID
EILMO=MOLIE
IILMO=MOLII
ÂLMOU=MOLÂU
ÂILMO=MOLÂI
HLMOO=MOLOH
LMNOO=MOLON,NOMOL
LMOOS=MOLOS
LMOOZ=MOLOZ
ÂIMMO=MOMÂI
MMNOO=MONOM
AMNOT=MONTA,MOTAN,TOMNA
ĂMNOT=MONTĂ
EMNOT=MONTE
IMOPŞ=MOPŞI
AMORR=MORAR
AMORV=MORAV
ĂGMOR=MORGĂ
IMOOR=MOROI
MNOOR=MORON
ĂMORS=MORSĂ
EMORS=MORSE
ĂMORU=MORUĂ
MNORU=MORUN
ĂMORV=MORVĂ
EMORV=MORVE,VOMER
MOORS=MOSOR
CIMOŞ=MOŞIC
EIMOŞ=MOŞIE
EMOTT=MOTET,TOTEM
IMOTV=MOTIV
CMOOT=MOTOC
MOORT=MOTOR
AEMOŢ=MOAŢE
AĂMOŢ=MOAŢĂ
AMOTŢ=MOŢAT
ĂIMOŢ=MOŢĂI
EEJMR=MREJE
EEMNR=MRENE
EIJMR=MREJI
ACEMU=MUCEA
CDEMU=MUCED
CEHMU=MUCHE
CHIMU=MUCHI
CMOSU=MUCOS
CMSUU=MUCUS
ĂFLMU=MUFLĂ
EFLMU=MUFLE
GIIMT=MIGIT
GMRUU=MUGUR
CIIMU=MUICI
CIJMU=MUJIC
AJLMU=MULAJ
ĂLMSU=MULSĂ
ILMŞU=MULŞI
ELMSU=MULSE
ĂLMTU=MULTĂ
ILMŢU=MULŢI
ELMTU=MULTE
ILMTU=MULTI,ULTIM
EIMMU=MUMIE
IIMMU=MUMII
ĂCMNU=MUNCĂ
CIMNU=MUNCI,MUNCI
EMNTU=MUNTE
IMNŢU=MUNŢI
ALMRU=MURAL
GIMRU=MURGI
ĂMRSU=MURSĂ
EMRSU=MURSE
IMRUU=MURUI
AIMSU=MUSAI
ĂCMSU=MUSCĂ
EMŞTU=MUŞTE
IMSUU=MUSIU
MNOSU=MUSON
IMSTU=MUSTI,TIMUS
AMTTU=MUTAT
CIMTU=MUTIC
MNOTU=MUTON
ĂMRTU=MUTRĂ,TURMĂ
EIMŢU=MUŢIE
IMŢUU=MUŢIU
EMUUZ=MUZEU
EEMUZ=MUZEE
AÂGNŢ=NAGÂŢ
AABIN=NAIBA
AINST=NAIST
AĂINV=NAIVĂ
AIINV=NAIVI
AEINV=NAIVE
ABELN=NALBE
AĂLNT=NALTĂ
AILNŢ=NALŢI
AELNT=NALTE
ADNNU=NANDU
ALNOS=NASOL
AINTV=NATIV
AĂNRT=NATRĂ
AENRT=NATRE,RENTA,TRENA
AALNV=NAVAL
ALNUV=NAVLU
AALNZ=NAZAL
AANRZ=NAZAR,RAZNA
AINRZ=NAZIR
AÂNRZ=NAZÂR
ĂBINO=NĂBOI
ĂBCNU=NĂBUC
ĂDHNU=NĂDUH
ĂHNTU=NĂHUT
ĂEINR=NĂIER
ĂIJNT=NĂJIT
AĂLNŢ=NĂLŢA
ĂLMNO=NĂMOL
AĂNNŞ=NĂNAŞ
AĂNRV=NĂRAV,VRANĂ
ĂDNOR=NĂROD,RONDĂ
ĂINRU=NĂRUI,RUINĂ,URINĂ
ĂINPS=NĂSIP
ĂINOS=NĂSOI
ĂNOSS=NĂSOS
ĂCNSU=NĂSUC
ĂNSTU=NĂSUT,TUNSĂ
ĂNSŢU=NĂSUŢ
ĂELNŞ=NĂŞEL
AĂENŞ=NĂŞEA
ĂEINŞ=NĂŞEI,NĂŞIE
ĂCINŞ=NĂŞIC
ĂINŞT=NĂŞIT
ĂĂCNU=NĂUCĂ
ĂCENU=NĂUCE
ĂDNOV=NĂVOD
ĂINUZ=NĂZUI,UZINĂ
AEMNŢ=NEAMŢ
EIMNŢ=NEMŢI,NEMŢI
AENNT=NEANT
AENOŞ=NEAOŞ
AĂENU=NEAUĂ
BENNU=NEBUN
DEENR=NEDER
EEFNR=NEFER
ĂEFLN=NEFLĂ
EEFLN=NEFLE
EEGLN=NEGEL
EEGIN=NEGEI
EGNOS=NEGOS
EGNOŢ=NEGOŢ
EGINR=NEGRI,NEGRI
EGNRU=NEGRU
EEGNR=NEGRE
EGNSU=NEGUS
ĂCEIN=NEICĂ
EINOS=NEIOS
EEMNŞ=NEMEŞ
EEMNT=NEMET
CEINN=NENIC
EENPR=NEPER
ENOPT=NEPOT
DENOR=NEROD,RONDE
EINRV=NERVI
AENSŢ=NESAŢ
EENŞT=NEŞTE
DEENT=NETED,TENDE
ENOTT=NETOT
ĂEMNU=NEUMĂ
EEMNU=NEUME
EINOV=NEVOI,NEVOI,OVINE
ĂFIMN=NIMFĂ
EFIMN=NIMFE
CIIMN=NIMIC
AGINU=NIGAU
EGINN=NINGE
ĂINNS=NINSĂ
IINNŞ=NINŞI
EINNS=NINSE
INNOP=NIPON
IINPS=NISIP
EINŞT=NIŞTE
EIINŢ=NIŢEI
EILNV=NIVEL,VELIN
IINSX=NIXIS
AIMNZ=NIZAM
AINNŞ=NINAŞ
AĂDNO=NOADĂ
ADENO=NOADE
INOPŢ=NOPŢI
BILNO=NOBIL
CINOV=NOCIV
ADLNO=NODAL
DNOOS=NODOS
DLNOU=NODUL
AGINO=NOGAI
ĂINOŢ=NOIŢĂ
ADMNO=NOMAD
ENNOT=NONET
ENNOU=NONEU
AENOR=NOREA
AMNOR=NORMA,ROMAN
ĂMNOR=NORMĂ
CNOOR=NOROC
DNOOR=NOROD,RONDO
INOOR=NOROI
NOORS=NOROS
NORŢU=NORUŢ
INOŞT=NOŞTI
ANORT=NOTAR,ORNAT,TRONA
ANORU=NOUAR
INORU=NOURI,NUORI
INOŢU=NOUŢI
ĂNOŢU=NOUŢĂ
ENOŢU=NOUŢE
ACNOV=NOVAC
ANOTV=NOVAT
BCNUU=NUBUC
CENTU=NUCET
CNŢUU=NUCUŢ
ĂFNRU=NUFĂR
ĂMNRU=NUMĂR
EMNNU=NUMEN
ĂNNTU=NUNTĂ
INNŢU=NUNŢI
INNTU=NUNTI
ĂCNRU=NURCĂ
CINRU=NURCI,RUNIC
ĂNRSU=NURSĂ
ENRSU=NURSE
INRTU=NUTRI
INTUU=NUTUI
AĂCOR=OACĂR,OCARĂ
AEOPS=OASPE
AEOST=OASTE
AĂBDO=OBADĂ,OBĂDA
ĂBIOR=OBĂRI,ROIBĂ
ĂBEOZ=OBEZĂ
BEEOZ=OBEZE
ĂBDIO=OBIDĂ
BDEIO=OBIDE
BDIIO=OBIDI
BELOŢ=OBLEŢ
BCILO=OBLIC
BLNOO=OBLON
ABELO=OABLE
BILOO=OBOLI
BIOOR=OBORI
BIOOS=OBOSI
BEOOT=OBOTE
ABORŢ=OBRAŢ
ABORZ=OBRAZ
BCOOR=OBROC
BEOŞT=OBŞTE
BIOŞT=OBŞTI
BOTUZ=OBTUZ
BEOUZ=OBUZE
ĂCIOR=OCĂRI,OCĂRI
ĂCIOT=OCĂIT
ĂCÎOR=OCĂRÎ
CEHOŢ=OCHEŢ
ĂCINO=OCINĂ
ACNOŞ=OCNAŞ
CILOO=OCOLI
CEOTT=OCTET
ACOPU=OCUPA
ADEIO=ODAIE
AĂDOT=ODATĂ
DENOO=ODEON
DGNOO=ODGON
DIOOS=ODIOS
AFOTT=OFTAT
AGIOR=OGARI
ACEGO=OGEAC
ĂGIOV=OGIVĂ
EGIOV=OGIVE
AGIOO=OGOIA
GIOOT=OGOIT
GÎOOR=OGORÎ
AĂBHO=OHABĂ
ABEHO=OHABE
CHIMO=OHMIC
EIIOR=OIERI
CEIOS=OIESC
EIOŞT=OIŞTE
IIOŞT=OIŞTI
ILORU=OLURI,URLOI
ACILO=OLACI
AILNO=OLANI
AELNO=OLANE
AĂLNO=OLANĂ
AELOT=OLEAT,TAOLE
AEILO=OLEIA
ELMOU=OLEUM
ĂILOŢ=OLIŢĂ
EILOŢ=OLIŢE,OŢELI
ĂILOV=OLIVĂ,VIOLĂ
EILOV=OLIVE,VIOLE,VOLEI
ALMOZ=OLMAZ
GILOO=OLOGI
ALORT=OLTAR
ELOŢU=OLUŢE,OULEŢ
EIMOŢ=OMEŢI,OMEŢI
AEGMO=OMEGA
ĂDIMO=OMIDĂ
IIMOZ=OMIZI
EIMOS=OMISE
EIMOT=OMITE
ÎMOOR=OMORÎ
ANOOR=ONORA
GNOOO=OOGON
ILOOT=OOLIT
IOPRU=OPURI
ACEOP=OPACE
AĂCOP=OPACĂ
AIOPŢ=OPAIŢ
AELOP=OPALE
ĂIOPR=OPĂRI
AEOPR=OPERA,OPREA
ĂEOPR=OPERĂ
EEOPR=OPERE
AIOPT=OPIAT
AINOP=OPINA
EIOPS=OPISE
IMOPU=OPIUM
EGOPR=OPREG
IOPRT=OPRIT,TROPI
AOPSS=OPSAS
CIOPT=OPTIC,TOPIC
IMOPT=OPTIM
ENOPU=OPUNE
ĂOPSU=OPUSĂ
IOPŞU=OPUŞI
EOPSU=OPUSE
OPSTU=OPUST
AĂLOR=ORALĂ
AELOR=ORALE
AJNOR=ORANJ
ANORZ=ORANZ
AĂORR=ORARĂ
AIORR=ORARI
AEORR=ORARE
AEORŞ=ORAŞE
AĂBOR=OARBĂ,ROABĂ,ROABĂ
BEORŢ=ORBEŢ
DEIOR=ORDIE,RODIE
DIIOR=ORDII,RODII,RODII
DINOR=ORDIN,RODIN
AEORV=OREAV,OVARE
AFNOR=ORFAN
CFIOR=ORFIC
GIIOR=ORGII
ÂDNOR=ORÂND
ADJOR=ORJAD,RODAJ
LNOOR=ORLON
IOORR=ORORI
AEORZ=OARZE,ZOREA
AORRZ=ORZAR
AANOS=OSANA
BEIOS=OSEBI
IMOSU=OSMIU
IOOSŞ=OSOŞI
ĂOPSŢ=OSPĂŢ
AOSŞT=OSTAŞ
EIOST=OSTIE,TEIOS
IIOST=OSTII
ILOST=OSTIL
IOOST=OSTOI
AORSU=OSUAR
EOSŢU=OSUŢE
AEJOT=OTAJE
AĂOTV=OTAVĂ,OVATĂ
ĂIOTV=OTĂVI,VOITĂ
COPTU=OTCUP
GNOOT=OTGON
ĂIOTT=OTITĂ
EIOTT=OTITE
AOOTV=OTOVA
ĂIORŢ=OŢĂRI,RĂŢOI
ĂÎORŢ=OŢĂRÎ
EELOŢ=OŢELE
EIORŢ=OŢERI
EÎORŢ=OŢERÎ
EIOTŢ=OŢETI
EÎOTŢ=OŢETÎ
IOOSŢ=OŢIOS
OORŞU=OUŞOR
AĂLOV=OVALĂ
AILOV=OVALI,VIOLA
AELOV=OVALE
AIOŢV=OVAŢI
AEOTV=OVATE
EEOSV=OVESE
EEOVZ=OVEZE
IILOV=OVILI
ĂINOV=OVINĂ
IINOV=OVINI
DIOOV=OVOID
EIORV=OVREI,VOIRE
EORUV=OVREU
ELOUV=OVULE,VOLEU
IIOXZ=OXIZI
ADIOX=OXIDA
IORUX=OXIUR
ĂENOZ=OZENĂ
EENOZ=OZENE
ANOOZ=OZONA
ABIRŢ=RABIŢ
AĂBLR=RABLĂ
ABELR=RABLE
AACLR=RACLA
AADRR=RADAR
ADIOR=RADIO
ADIRU=RADIU
ADMOR=RADOM
ADNOR=RADON,RODAN
ADORU=RADOU
AFIIR=RAFII
AAHRT=RAHAT
AHIRS=RAHIS
AINOR=RAION
AĂIRT=RAITĂ,TIARĂ
AAHJR=RAJAH
AAILR=RALIA
ADILR=RALID
AĂMPR=RAMPĂ
AĂDNR=RANDĂ
AĂGNR=RANGĂ
ĂGINR=RĂNGI
AĂNPR=RAPĂN
AELPR=RAPEL
ADIPR=RAPID
AARST=RASAT,TRASA
ALORS=RASOL
AĂCRŞ=RAŞCĂ
ĂCIRŞ=RĂŞCI,RICŞĂ,RIŞCĂ
AELRŞ=RAŞEL,RELAŞ
AĂPRŞ=RAŞPĂ
AEPRŞ=RAŞPE
AARTT=RATAT,TARAT,TRATA
AERŞT=RATEŞ
AERTU=RATEU
AORŞT=RATOŞ,ROTAŞ
AĂCRŢ=RAŢCĂ,ŢARCĂ
ACERŢ=RAŢCE
AEIRŢ=RAŢIE
AACRV=RAVAC
AEIRZ=RAZIE,ZIARE
AĂNRZ=RAZNĂ
AENRZ=RAZNE
ĂBJOR=RĂBOJ
ĂBRŞU=RĂBUŞ
AĂCNR=RĂCAN
AĂCRR=RĂCAR
ĂCINR=RĂCNI
ĂEGRT=RĂGET
ĂGORZ=RĂGOZ
ĂINRT=RĂNIT
ĂĂIPR=RĂPĂI
ĂIPRT=RĂPIT
ĂPRSU=RĂPUS
ĂIRRŞ=RĂRIŞ
ĂIRRT=RĂRIT
AĂDRS=RĂSAD
ĂIRST=RĂSTI
ĂERTZ=RĂTEZ
AĂRRV=RĂVAR,VĂRAR
AĂRŞV=RĂVAŞ
AĂDRZ=RĂZDA,ZĂDAR
ĂERŞZ=RĂZEŞ
ĂINRZ=RĂZNI
ĂORRZ=RĂZOR
ĂIRUZ=RĂZUI,UZĂRI,ZURĂI
ĂRŞUZ=RĂZUŞ
AĂELR=REALĂ
AEELR=REALE
ABBER=REBAB
BEELR=REBEL
CEORT=RECTO
CELRU=RECUL,ULCER
DEEIR=REDIE
DEIIR=REDII
DEIRU=REDIU
DERSU=REDUS
CEEFR=REFEC
EFRUZ=REFUZ
AEGLR=REGAL,REGLA
EEGIR=REGIE
EGIIR=REGII
EEJRT=REJET
EELRU=RELEU
EEELR=RELEE
ELNOR=RELON
AELNR=RENAL
AENNR=RENAN
EEINR=RENIE
EINRŞ=RENIŞ
EINRU=RENIU,REUNI,RUINE,UNIRE,URINE
ĂENRT=RENTĂ,TERNĂ,TRENĂ
EEPRR=REPER
EORŞU=REŞOU
EERTZ=RETEZ,TREZE
EORRT=RETOR
ERRTU=RETUR
ERŞTU=RETUŞ
AEERŢ=REŢEA
ĂEMRU=REUMĂ
EERRV=REVER,VRERE
EILRZ=REZIL,ZILER
ELORZ=REZOL
ENORZ=REZON
ADIRT=RIDAT
FILRU=RIFLU
DGIIR=RIGID
EILMR=RIMEL
ACIRS=RISCA
IORRT=RITOR,TORRI,TRIOR
IORST=RITOS,ROSTI
IIRŢU=RIŢUI,ŢIURI
AIRTZ=RIZAT
CIIRZ=RIZIC
IILRZ=RIZIL
IMORZ=RIZOM
ÂÂGIR=RÂGÂI
ÂIORS=RÂIOS
ÂIMNR=RÂMNI
ÂIJNR=RÂNJI,RÂNJI
ĂÂNRZ=RÂNZĂ,RÂZNĂ,ZÂRNĂ
ÂENRZ=RÂNZE,RÂZNE,ZÂRNE
ÂOPRS=RÂPOS
ÂERST=RÂSET
ÂINRŞ=RÂŞNI
AÂNRT=RÂTAN
ÂIRRU=RÂURI
AÂRRU=RÂURA
ĂÂNRV=RÂVNĂ
ÂENRV=RÂVNE
ÂINRV=RÂVNI
BOORT=ROBOT
CEHOR=ROCHE
DIORT=RODIT,TORID,TORID,TRIOD
DIORU=RODIU
DOORR=RODOR
DOORS=RODOS
GOORZ=ROGOZ
IIORR=ROIRI
ALNOR=ROLAN
ÂMNOR=ROMÂN
OOPRT=ROPOT,TOPOR
AĂORS=ROASĂ
ĂCORŞ=ROŞCĂ
IORŞT=ROŞIT,ROTIŞ,TORŞI
EIORŞ=ROŞIE
IIORŞ=ROŞII
AORRT=ROTAR
AORTT=ROTAT,TROTA
IORTT=ROTIT,TORIT
OORRT=ROTOR
AORRU=ROURA
IORUZ=ROZIU
EIORZ=ROZIE
AEJRU=RUAJE
ĂBLRU=RUBLĂ
BELRU=RUBLE
ADRRU=RUDAR,URDAR
FORSU=RUFOS
BGIRU=RUGBI
EGRTU=RUGET
GORSU=RUGOS
AINRU=RUINA,URINA
AJRRU=RUJAR
EJRTU=RUJET
AJLRU=RULAJ
ILRUU=RULIU,URLUI
LORUU=RULOU
ÂMNRU=RUMÂN
EMNRU=RUMEN
MMRUY=RUMMY
EMPRU=RUMPE
ĂDNRU=RUNDĂ
DENRU=RUNDE
IIPRU=RUPII
ĂPRTU=RUPTĂ,TRUPĂ
IPRŢU=RUPŢI
EPRTU=RUPTE,TRUPE
ALRRU=RURAL
AABCT=TABAC
ABEIT=TABIE
ABIIT=TABII,TIBIA
AÂCMT=TACÂM
AAFTT=TAFTA
AEFTT=TAFTE
AĂGMT=TAGMĂ
AÂHNT=TAHÂN
AĂINT=TAINĂ
AEINT=TAINE
AIORT=TAIOR
AAJLT=TALAJ
AALŞT=TALAŞ
AIILT=TALII
AILTU=TALIU,TULAI,UTILA
AÂLMT=TALÂM
ALNOT=TALON
AĂLPT=TALPĂ
ĂILPT=TĂLPI
ALSTU=TALUS
ALTUZ=TALUZ
AÂMŞT=TAMÂŞ
AAJNT=TANAJ
AANTT=TANAT
AĂNTT=TANĂT
AAENT=TANEA
AINNT=TANIN
AINTT=TANTI,TITAN
AĂLOT=TAOLĂ
AAJPT=TAPAJ
AEPTT=TAPET
AIPRT=TAPIR,TIPAR
AAFRT=TARAF
AARRT=TARAR
AARŞT=TARAŞ
AĂGRT=TARGĂ
ĂGIRT=TĂRGI
AFIRT=TARIF
AERTT=TARTE,TETRA,TRATE
AESTU=TASEU
AĂCŞT=TAŞCĂ
ĂIŞTT=TĂŞTI
AATTU=TATUA
AANTV=TAVAN
ADITX=TAXID
AIMTX=TAXIM
ĂĂCIT=TĂCĂI
ĂCTTU=TĂCUT
ĂEIRT=TĂIER,TĂRIE
ĂIOST=TĂIOS
ĂIPŞT=TĂPŞI
ĂÂMRT=TĂRÂM
AĂRTT=TĂTAR,TRATĂ
ĂCITT=TĂTIC
ĂÂNTT=TĂTÂN,TÂNTĂ
ĂINTU=TĂUNI,UNITĂ
ĂENTU=TĂUNE
ĂIŞTU=TĂUŞI
AĂEMT=TEAMĂ
ACENT=TEANC
EHNOT=TEHNO
ĂEINT=TEINĂ
EISTT=TEIST
EELTX=TELEX
EMOPT=TEMPO
EMTTU=TEMUT
ĂDENT=TENDĂ
EEINT=TENIE
EIINT=TENII
EINST=TENIS
ENORT=TENOR
ĂENTT=TENTĂ
EENTT=TENTE
AERTZ=TERAZ,TREAZ
EEMRT=TERME,TREME
ĂERTŢ=TERŢĂ,TERŢĂ
EIRTŢ=TERŢI
EERTŢ=TERŢE,TERŢE
ĂELST=TESLĂ
EELST=TESLE
AESTT=TESTA
EIŞTT=TEŞIT
ĂCETU=TEUCĂ
ĂEGTU=TEUGĂ
EEGTU=TEUGE
EETTX=TEXTE
BEITT=TIBET
BIIIT=TIBII
ĂCIIT=TICĂI
ĂCINT=TICNĂ
CIINT=TICNI
CIIST=TICSI
AFINT=TIFAN
CFIIT=TIFIC
FINOT=TIFON
FIOST=TIFOS
ĂGIIT=TIGĂI
GIRTU=TIGRU
GIIRT=TIGRI
ĂGITV=TIGVĂ,TIVGĂ
EGITV=TIGVE
ĂHINT=TIHNĂ
EHINT=TIHNE
HIINT=TIHNI
ĂDILT=TILDĂ
DEILT=TILDE
FIIMT=TIMFI
DIIMT=TIMID
ILMOT=TIMOL
IIMPT=TIMPI
ĂDINT=TINDĂ
INOST=TINOS
IILOT=TIOLI
CIIPT=TIPIC
EIIPT=TIPIE
IIIPT=TIPII
ILTTU=TITLU
AIRTT=TITRA
IRTTU=TITRU,TURTI
EIRTT=TITRE,TRETI
GIITV=TIVGI
IITTV=TIVIT
CIITZ=TIZIC
ÂÂCIT=TÂCÂI
ÂILTV=TÂLVI
ĂÂMPT=TÂMPĂ
ÂIMPT=TÂMPI,TÂMPI
ÂEMPT=TÂMPE
ĂÂNRT=TÂNĂR,TÂRNĂ
ÂIJNT=TÂNJI
ÂINTŢ=TÂNŢI
ÂENTT=TÂNTE
ĂÂFRT=TÂRFĂ
ÂEFRT=TÂRFE
ÂÂIRT=TÂRÂI
ÂÂRŞT=TÂRÂŞ
ÂÂRTT=TÂRÂT
ĂÂLRT=TÂRLĂ
ÂELRT=TÂRLE
ÂENRT=TÂRNE
ÂIRŞT=TÂRŞI,TÂRŞI
ĂEMTZ=TMEZĂ
EEMTZ=TMEZE
AĂCOT=TOACĂ
AOSTT=TOAST
ABOŞT=TOBAŞ
ACOTT=TOCAT
FOSTU=TOFUS,TUFOS
AGIOT=TOIAG
AJNOT=TONAJ
DNOOT=TONDO
NOOTU=TONOU
INOTŢ=TONŢI
NOSTU=TONUS,UNTOS
AOPTZ=TOPAZ
IOPTT=TOPIT
OPTUZ=TOPUZ
IORTU=TORIU,TUIOR
NOORT=TORON
ĂORTT=TORTĂ
ĂORTŢ=TORŢĂ
EORTŢ=TORŢE
AĂOTT=TOATĂ
AEOTT=TOATE
ALOTT=TOTAL
ALOTV=TOVAL
CIOTX=TOXIC
AĂMRT=TRAMĂ
ACNRT=TRANC
ANRST=TRANS
AĂPRT=TRAPĂ
AĂRST=TRASĂ
ALRTU=TRAUL,ULTRA,URLAT
AĂDRT=TRĂDA
ĂIRTT=TRĂIT
EIJRT=TREJI
ĂEMRT=TREMĂ
ĂERST=TRESĂ
EIRTZ=TREZI
IRSTT=TRIST
CNORT=TRONC
CORST=TROSC
ĂDRTU=TRUDĂ
DERTU=TRUDE
ĂFRTU=TRUFĂ
ĂRSTU=TRUSĂ
RSTTU=TRUST
ABJTU=TUBAJ
ACNTU=TUCAN
AFNTU=TUFAN
FITTU=TUFIT
EIŞTU=TUIEŞ
EILTU=TULEI,TULEI,UTILE
ELTUU=TULEU
ILTŢU=TULŢI
ĂBMTU=TUMBĂ
BEMTU=TUMBE
LMTUU=TUMUL
ANRTU=TUNAR,TURNA,UNTAR
DENTU=TUNDE
ELNTU=TUNEL
ENTTU=TUNET
INŞTU=TUNŞI
ENSTU=TUNSE
EPTUU=TUPEU
CIRTU=TURCI
ĂRTTU=TURTĂ
ERTTU=TURTE
IRTUU=TURUI,URUIT
ESTTU=TUSET
ORSTU=TUSOR
EŞTUU=TUŞEU
IŞTTU=TUŞIT
ITTUU=TUTUI
NTTUU=TUTUN
DEETW=TWEED
ISTTW=TWIST
AĂGLŢ=ŢAGLĂ
AEGLŢ=ŢAGLE
ACEIŢ=ŢAICE
AAPPŢ=ŢAPAP
AINPŢ=ŢAPIN
AOPŞŢ=ŢAPOŞ
AARTŢ=ŢARAT
AĂNRŢ=ŢARNĂ,ŢĂRAN
AINRŢ=ŢARNI
ĂHINŢ=ŢĂHNI
ĂIOPŢ=ŢĂPOI,ŢOPĂI
ĂCPŢU=ŢĂPUC
ĂĂNRŢ=ŢĂRNĂ
ĂRŞŢU=ŢĂRUŞ
AĂEPŢ=ŢEAPĂ
AĂERŢ=ŢEARĂ
EESTŢ=ŢESTE
AĂEŢV=ŢEAVĂ
EOPSŢ=ŢEPOS
ESTŢU=ŢESUT
AERŢV=ŢEVAR
EOSŢV=ŢEVOS
EIŢUV=ŢEVUI
ĂCILŢ=ŢICLĂ
CIINŢ=ŢICNI,ŢINCI
ĂGIIŢ=ŢIGĂI
AGINŢ=ŢIGAN
ÂGIIŢ=ŢIGÂI
ĂGILŢ=ŢIGLĂ
EGILŢ=ŢIGLE
ĂINTŢ=ŢINTĂ
EINTŢ=ŢINTE
IINTŢ=ŢINTI
INTŢU=ŢINUT
AIPRŢ=ŢIPAR
AIPTŢ=ŢIPAT
ĂIPTŢ=ŢIPĂT
EIPTŢ=ŢIPET
ĂILPŢ=ŢIPLĂ
EILPŢ=ŢIPLE
EIIŢŢ=ŢIŢEI
IILŢV=ŢIVIL,ŢIVLI
ĂÂFNŢ=ŢÂFNĂ
ÂEFNŢ=ŢÂFNE
ÂFINŢ=ŢÂFNI
ĂÂHLŢ=ŢÂHLĂ
ÂEHLŢ=ŢÂHLE
ÂCINŢ=ŢÂNCI
ĂÂCNŢ=ŢÂNCĂ
ÂCENŢ=ŢÂNCE
ÂÂIRŢ=ŢÂRÂI
ÂINŞŢ=ŢÂŞNI
ÂIŞTŢ=ŢÂŞTI
ÂÂIŢŢ=ŢÂŢÂI
AĂLOŢ=ŢOALĂ
AELOŢ=ŢOALE
AĂOPŢ=ŢOAPĂ
AEOPŢ=ŢOAPE
ĂCIOŢ=ŢOCĂI
ELOTŢ=ŢOLET
LOŢŢU=ŢOLUŢ
ACLŢU=ŢUCAL
GIŢUU=ŢUGUI
CLŢUU=ŢULUC
ĂIPŢU=ŢUPĂI
IŞTŢU=ŢUŞTI
IŢŢUU=ŢUŢUI
CDEIU=UCIDE
EEGRU=UGERE
DEIOU=UIDEO
IITTU=UITIT
CITUU=UITUC
IIUUU=UIUIU
ACELU=ULCEA
CLSUU=ULCUS
EEILU=ULEIE
AEILU=ULEIA
AELMU=ULEMA
ĂILŢU=ULIŢĂ
ĂBLUU=ULUBĂ
BELUU=ULUBE
CELUU=ULUCE
ĂCLUU=ULUCĂ
AĂMNU=UMANĂ
EIMRU=UMERI
BIMRU=UMBRI
ĂDEMU=UMEDĂ
EIMUZ=UMEZI,UMEZI,ZEMUI
DEEMU=UMEDE
AFLMU=UMFLA
ĂILMU=UMILĂ
IMORU=UMORI
ELMPU=UMPLE
EELNU=UNELE,UNELE
CHINU=UNCHI
DINTU=UNDIT
DINOU=UNDOI
DINUU=UNDUI
AGNRU=UNGAR
GHINU=UNGHI
GNRUU=UNGUR
AINTU=UNIAT
IINRU=UNIRI
IINŢU=UNIŢI
EINTU=UNITE
AERRU=URARE
ĂIRRU=URĂRI
AIRŢU=URAŢI
CRŞUU=URCUŞ
GIIRU=URGII
AIRŞU=URIAŞ,UŞARI
ĂÂRTU=URÂTĂ
ÂIRŢU=URÂŢI,URÂŢI
ÂERTU=URÂTE
LPRUU=URLUP
AMRŞU=URMAŞ
ARRSU=URSAR
IRSTU=URSIT
IORSU=URSOI
NORSU=URSON
RSUUZ=URSUZ
IRTUZ=URZIT
ACSTU=USCAT
ASŞTU=USTAŞ
ĂIŞŢU=UŞIŢĂ
EIŞŢU=UŞIŢE
IORŞU=UŞORI
ARŞUU=UŞURA
ERŞUU=UŞURE
ĂŞŢUU=UŞUŢĂ
EŞŢUU=UŞUŢE
EERTU=UTERE
ĂILTU=UTILĂ
AJRUV=UVRAJ
ĂLUUV=UVULĂ
ELUUV=UVULE
IRUUZ=UZURI,UZURI,ZURUI
AERUZ=UZARE
AĂTUZ=UZATĂ
AIŢUZ=UZAŢI
AETUZ=UZATE
BCEUZ=UZBEC
EINUZ=UZINE
AITUZ=UZITA
ALUUZ=UZUAL
ĂRUUZ=UZURĂ
AACTV=VACAT
AĂDRV=VADRĂ
AGINV=VAGIN
AGNOV=VAGON
AELTV=VALET
AELUV=VALEU
ADILV=VALID
AIILV=VALII
AĂLMV=VALMĂ
ĂILMV=VĂLMI
ALNOV=VALON,VOLAN
AALSV=VALSA,VASAL
AĂLVV=VALVĂ
AELVV=VALVE
AALMV=VAMAL
AEMŞV=VAMEŞ
AĂMPV=VAMPĂ
AEMPV=VAMPE
AOPRV=VAPOR
ACERV=VAREC
AIRUV=VARIU
AIIRV=VARII
ARSUV=VARUS
AĂRVZ=VARZĂ,ZARVĂ
EERVZ=VERZE
AELSV=VASEL
AĂSTV=VASTĂ
AIŞTV=VAŞTI
AESTV=VASTE
AIRTV=VATIR
AOSTV=VATOS
AĂRTV=VATRĂ,VĂRAT
EERTV=VETRE
AĂCRV=VĂCAR
AĂDNV=VĂDAN
ĂDITV=VĂDIT
ĂDUVV=VĂDUV
AĂGŞV=VĂGAŞ
AĂITV=VĂITA
ĂIMUV=VĂMUI
ĂĂIPV=VĂPĂI,VĂPĂI
ĂIPSV=VĂPSI
ĂORSV=VĂROS
AĂRSV=VĂRSA,VĂSAR
ĂIRUV=VĂRUI
ĂSŢUV=VĂSUŢ
AĂFTV=VĂTAF
AĂŞTV=VĂTAŞ
AĂTVV=VĂTAV
ĂITUV=VĂTUI
ĂTUVZ=VĂZUT
CEHIV=VECHI
CEEHV=VECHE
CEEIV=VECIE
CEINV=VECIN
CEIUV=VECUI
ADEEV=VEDEA
EEGHV=VEGHE
EGHIV=VEGHI
EILTV=VELIT
ELRUV=VELUR
AELNV=VENAL
EENTV=VENET
EINNV=VENIN
EINTV=VENIT
ENOSV=VENOS
EIRVZ=VERZI
CEIRV=VERIC
EFIRV=VERIF
EORSV=VEROS,VERSO
ĂERVV=VERVĂ
EELSV=VESEL
ĂESTV=VESTĂ
EESTV=VESTE
EIŞTV=VEŞTI,VEŞTI
ĂCEŞV=VEŞCĂ
AETVX=VEXAT
AĂIŢV=VIAŢĂ
EIIŢV=VIEŢI,VIŢEI
ACIRV=VICAR,VRACI
ACIIV=VICIA
CIIUV=VICIU
CIIIV=VICII
ĂDIMV=VIDMĂ
DEIMV=VIDME
ĂDIRV=VIDRĂ
DEIRV=VIDRE
ĂEILV=VIELĂ
EIRSV=VIERS
FIORV=VIFOR
ILOSV=VILOS
AINŢV=VINAŢ
CIINV=VINCI
DEINV=VINDE
IILNV=VINIL
INŢUV=VINUŢ
IIORV=VIORI,VOIRI
EIIPV=VIPIE
IIIPV=VIPII
ĂILPV=VIPLĂ
EILPV=VIPLE
AIJRV=VIRAJ
IILRV=VIRIL
IRSUV=VIRUS
IINŞV=VIŞIN
AILTV=VITAL
AEIŢV=VIŢEA
EILŢV=VIŢEL
IIŢUV=VIŢIU
IIIŢV=VIŢII
IOSŢV=VIŢOS
AITVV=VIVAT
IIRVZ=VIZIR
INOVZ=VIZON,ZVONI
ÂIIJV=VÂJII
ÂÂIJV=VÂJÂI
ĂÂFLV=VÂLFĂ
ÂEFLV=VÂLFE
ĂÂLVV=VÂLVĂ
ÂELVV=VÂLVE
ĂÂNTV=VÂNĂT
ÂNOSV=VÂNOS
ĂÂRŞV=VÂRŞĂ
ÂERŞV=VÂRŞE
ĂÂLSV=VÂSLĂ
ÂELSV=VÂSLE
ÂILSV=VÂSLI
AÂCŞV=VÂŞCA
AĂGLV=VLAGĂ
AĂHLV=VLAHĂ
AHILV=VLAHI
AEHLV=VLAHE
AALOV=VOALA
ĂCDOV=VODCĂ
CDIOV=VODCI
DEORV=VODER
AIJOV=VOIAJ
IOOSV=VOIOS
IIOŢV=VOIŢI
EIOTV=VOITE
ELOTV=VOLET,VOLTE
CLOOV=VOLOC
GLOOV=VOLOG
ILOŢV=VOLŢI
ĂLOTV=VOLTĂ
LMOUV=VOLUM
AMOTV=VOMAT
IOPSV=VOPSI
ĂBORV=VORBĂ
BEORV=VORBE
BIORV=VORBI
IOŞTV=VOŞTI
ĂCOTV=VOTCĂ
CIOTV=VOTCI
IOTVV=VOTIV
IORTV=VOTRI,VOTRI,VTORI
ORTUV=VOTRU
MOTUV=VOTUM
ĂIJRV=VRĂJI,VRĂJI
AENRV=VRANE
EEMRV=VREME
EIMRV=VREMI
EIRRV=VRERI
ENRUV=VREUN
ĂRTUV=VRUTĂ,VURTĂ
ERTUV=VRUTE,VURTE
EITUV=VUIET
IIRUV=VUIRI
ELPUV=VULPE
ILPUV=VULPI
ĂLUVV=VULVĂ
ELUVV=VULVE
ĂCTUV=VUTCĂ
CITUV=VUTCI
ARUVV=VUVAR
IUUVV=VUVUI
BEERW=WEBER
ADIIW=WIDIA
ENNOX=XENON
EERSX=XERES
EORXX=XEROX
EILNX=XILEN
AIRYZ=YARZI
ABETZ=ZABET,ZBATE
AADRZ=ZADAR
ADEIZ=ZADIE
ADIIZ=ZADII
AAHRZ=ZAHAR
AĂHRZ=ZAHĂR
AĂCIZ=ZAICĂ
AĂFIZ=ZAIFĂ
AFIIZ=ZAIFI
AEFIZ=ZAIFE
AFIMZ=ZAIMF
AĂCMZ=ZAMCĂ
AAPTZ=ZAPAT
AIPSZ=ZAPIS
AAPRZ=ZARPA
ĂBNUZ=ZĂBUN
AĂCEZ=ZĂCEA
ĂDFUZ=ZĂDUF
ĂDHUZ=ZĂDUH
AĂGNZ=ZĂGAN
AĂGŞZ=ZĂGAŞ
AĂGZZ=ZĂGAZ
ĂĂHIZ=ZĂHĂI
AĂLRZ=ZĂLAR
ĂGLOZ=ZĂLOG
ĂDLUZ=ZĂLUD
AĂNTZ=ZĂNAT
ĂĂIPZ=ZĂPĂI
ĂOPRZ=ZĂPOR
ĂIPSZ=ZĂPSI
ĂCPUZ=ZĂPUC
AĂRRZ=ZĂRAR
ĂISTZ=ZĂSTI
ĂNOTZ=ZĂTON
ĂDOVZ=ZĂVOD
ĂIOVZ=ZĂVOI
ĂORVZ=ZĂVOR
ABNŢZ=ZBANŢ
BEGNZ=ZBENG
BCIIZ=ZBICI
BCEIZ=ZBICE
BILŢZ=ZBILŢ
BIIRZ=ZBIRI
ÂBNŢZ=ZBÂNŢ
ÂBNRZ=ZBÂRN
ABRUZ=ZBURA,ZURBA
AEELZ=ZEALE
AĂEMZ=ZEAMĂ
ĂBERZ=ZEBRĂ
ACEEZ=ZECEA
CEERZ=ZECER
CEEHZ=ZECHE
CEHIZ=ZECHI
EEGHZ=ZEGHE
EGHIZ=ZEGHI
ĂEINZ=ZEINĂ
EEINZ=ZEINE
ĂEIŢZ=ZEIŢĂ
EEIŢZ=ZEIŢE
AELRZ=ZELAR
ELOSZ=ZELOS
EMOSZ=ZEMOS
EINTZ=ZENIT
EORSZ=ZEROS
AEJŢZ=ZEŢAJ
EIŢUZ=ZEŢUI
ÂGITZ=ZGÂIT
ĂGRUZ=ZGURĂ
ACIŞZ=ZICAŞ
ADIRZ=ZIDAR
DIITZ=ZIDIT
DIIUZ=ZIDUI
GIOTZ=ZIGOT
AILŞZ=ZILAŞ
IIMŢZ=ZIMŢI
AIMŢZ=ZIMŢA
ACINZ=ZINCA
ÂBIMZ=ZÂMBI
ÂÂIZZ=ZÂZÂI
ILOŢZ=ZLOŢI
EIMOZ=ZMEOI
EMRUZ=ZMEUR
AEIOZ=ZOAIE
AĂNOZ=ZOANĂ
AENOZ=ZOANE
BIOTZ=ZOBIT
BNOOZ=ZOBON
DEIOZ=ZODIE
DIIOZ=ZODII
IOOSZ=ZOIOS
ALNOZ=ZONAL
ĂIOPZ=ZOPĂI
IORTZ=ZORIT
AIUVZ=ZUAVI
EILUZ=ZULIE
FLUUZ=ZULUF
LMUUZ=ZULUM
ĂIPUZ=ZUPĂI
IPUUZ=ZUPUI
BERUZ=ZURBE
ĂIUZZ=ZUZĂI
ETUZZ=ZUZET
IUUZZ=ZUZUI
ELTVZ=ZVELT
